pc11_state_id,pc11_district_id,pc11_subdistrict_id,pc_hospitals_r,pc_hospitals_u,pc_hosp_beds_u,pc_pmed_pos_r,pc_pmed_pos_u,pc_docs_pos_r,pc_docs_pos_u,pc_docs_hosp_u,pc_docs_hosp_r,pc_clinics_r,pc_clinics_u,pc_clinic_beds_u,pc11_pca_tot_p,pc_clinics,pc_docs,pc_docs_hosp,pc_pmeds,pc_num_hospitals
01,001,00001,4,1,100,354,34,194,21,14,5,97,5,128,540914,102,215,19,388,5
01,001,00002,4,0,0,306,42,162,21,0,5,88,2,40,269268,90,183,5,348,4
01,001,00003,0,0,0,24,0,18,0,0,0,10,0,0,60129,10,18,0,24,0
01,002,00004,1,0,0,25,0,7,0,0,1,15,0,0,67596,15,7,1,25,1
01,002,00005,2,2,41,141,155,41,35,19,2,42,5,125,163325,47,76,21,296,4
01,002,00006,2,1,50,99,59,57,15,11,2,37,1,56,123312,38,72,13,158,3
01,002,00007,2,1,100,98,98,62,52,40,2,37,4,120,133780,41,114,42,196,3
01,002,00008,4,1,25,148,68,103,27,26,4,57,2,33,192681,59,130,30,216,5
01,002,00009,2,1,100,62,116,29,19,15,3,20,2,146,53416,22,48,18,178,3
01,003,00010,0,1,150,225,133,28,56,31,0,80,4,260,93961,84,84,31,358,1
01,003,00011,0,0,0,117,0,18,0,0,0,29,0,0,22433,29,18,0,117,0
01,003,00012,0,0,0,27,0,22,0,0,0,9,0,0,17093,9,22,0,27,0
01,004,00013,6,1,22,208,83,25,41,17,6,87,6,197,86461,93,66,23,291,7
01,004,00014,0,0,0,139,0,22,0,0,0,44,0,0,40548,44,22,0,139,0
01,004,00015,0,0,0,46,0,20,0,0,0,23,0,0,13793,23,20,0,46,0
01,005,00016,4,1,220,85,53,28,27,24,4,33,2,232,132732,35,55,28,138,5
01,005,00017,1,0,0,88,0,20,0,0,1,29,0,0,77947,29,20,1,88,1
01,005,00018,0,0,0,43,2,21,2,0,0,25,1,3,141318,26,23,0,45,0
01,005,00019,1,1,50,30,46,16,18,12,1,14,52,76,124755,66,34,13,76,2
01,006,00020,0,0,0,57,9,14,3,0,0,24,11,10,67773,35,17,0,66,0
01,006,00021,0,0,0,40,0,9,0,0,0,16,0,0,36227,16,9,0,40,0
01,006,00022,0,1,300,131,152,45,55,32,0,52,39,466,189067,91,100,32,283,1
01,006,00023,2,0,0,141,0,38,0,0,3,38,0,0,123027,38,38,3,141,2
01,006,00024,0,0,0,120,0,54,0,0,0,45,0,0,72619,45,54,0,120,0
01,006,00025,0,1,50,27,35,22,12,10,0,21,1,62,89374,22,34,10,62,1
01,006,00026,1,1,30,35,37,19,11,10,1,30,2,32,64215,32,30,11,72,2
01,007,00027,1,1,47,255,44,91,10,10,5,64,1,47,150882,65,101,15,299,2
01,007,00028,2,1,20,93,58,41,11,8,6,33,2,36,70810,35,52,14,151,3
01,007,00029,1,0,0,104,0,40,0,0,2,30,0,0,45996,30,40,2,104,1
01,007,00030,1,2,108,92,148,38,33,27,2,38,8,121,210840,46,71,29,240,3
01,007,00031,0,1,30,134,35,55,12,12,0,51,1,30,137471,52,67,12,169,1
01,008,00032,0,1,200,105,133,61,41,18,0,29,17,288,219913,46,102,18,238,1
01,008,00033,1,0,0,57,3,40,2,0,2,22,1,5,92563,23,42,2,60,1
01,008,00034,1,1,30,110,58,75,16,15,1,39,1,34,229155,40,91,16,168,2
01,008,00035,0,1,100,66,100,39,58,35,0,24,10,204,149649,34,97,35,166,1
01,008,00036,1,0,0,53,0,26,0,0,2,18,0,0,66954,18,26,2,53,1
01,008,00037,2,1,3,40,59,23,11,1,2,16,1,54,74867,17,34,3,99,3
01,008,00038,1,0,0,71,0,39,0,0,1,28,0,0,72564,28,39,1,71,1
01,008,00039,0,2,8,79,76,49,24,17,0,26,4,20,102251,30,73,17,155,2
01,009,00040,0,0,0,88,0,32,0,0,0,11,0,0,37992,11,32,0,88,0
01,009,00041,0,0,0,121,44,56,14,0,0,39,5,36,177738,44,70,0,165,0
01,009,00042,2,0,0,67,78,36,17,0,3,30,2,46,176502,32,53,3,145,2
01,010,00043,0,2,200,22,44,10,34,32,0,6,3,203,35788,9,44,32,66,2
01,010,00044,0,1,4,7,25,5,9,3,0,3,6,38,14174,9,14,3,32,1
01,011,00045,1,0,0,98,17,45,4,0,2,26,1,20,90686,27,49,2,115,1
01,011,00046,2,0,0,242,0,113,0,0,3,68,0,0,120934,68,113,3,242,2
01,011,00047,0,1,30,44,54,25,26,13,0,14,6,52,85818,20,51,13,98,1
01,012,00048,3,2,25,84,32,37,19,13,4,22,3,45,81564,25,56,17,116,5
01,012,00049,3,0,0,145,34,61,6,0,5,35,1,10,86507,36,67,5,179,3
01,012,00050,0,1,31,111,39,59,16,15,0,36,1,35,110196,37,75,15,150,1
01,012,00051,2,1,60,174,103,94,46,39,3,55,2,86,282132,57,140,42,277,3
01,013,00052,4,1,40,273,41,150,17,3,6,71,1,67,266175,72,167,9,314,5
01,014,00053,0,1,20,65,24,41,4,2,0,19,3,26,119884,22,45,2,89,1
01,014,00054,0,1,16,76,37,38,12,5,0,26,9,44,146801,35,50,5,113,1
01,014,00055,3,2,60,137,97,83,20,11,8,44,6,115,214565,50,103,19,234,5
01,014,00056,0,2,8,62,42,32,13,7,0,22,4,28,74103,26,45,7,104,2
01,014,00057,0,0,0,125,40,59,14,0,0,29,2,59,173682,31,73,0,165,0
01,014,00058,2,2,180,148,205,68,33,25,4,36,6,197,199395,42,101,29,353,4
01,015,00059,2,3,16,192,127,88,30,8,5,48,10,105,285379,58,118,13,319,5
01,015,00060,0,1,2,8,20,5,4,3,0,2,2,4,31893,4,9,3,28,1
01,015,00061,0,0,0,93,0,33,0,0,0,20,0,0,106817,20,33,0,93,0
01,016,00062,2,2,100,206,158,97,28,22,2,96,4,137,202685,100,125,24,364,4
01,016,00063,0,0,0,64,0,43,0,0,0,33,0,0,59955,33,43,0,64,0
01,016,00064,0,0,0,32,0,9,0,0,0,19,0,0,71839,19,9,0,32,0
01,016,00065,0,1,40,50,230,38,43,18,0,22,9,144,75305,31,81,18,280,1
01,017,00066,0,1,30,40,20,15,12,10,0,21,1,38,125045,22,27,10,60,1
01,017,00067,1,2,50,51,76,36,40,19,1,41,5,119,158668,46,76,20,127,3
01,018,00068,1,1,100,76,52,23,25,19,4,32,2,126,129489,34,48,23,128,2
01,018,00069,0,0,0,78,0,23,0,0,0,21,0,0,35572,21,23,0,78,0
01,018,00070,0,0,0,54,0,19,0,0,0,16,0,0,44087,16,19,0,54,0
01,018,00071,0,0,0,34,0,8,0,0,0,8,0,0,21548,8,8,0,34,0
01,019,00072,0,1,100,134,115,83,61,39,0,67,8,138,275451,75,144,39,249,1
01,019,00073,0,1,15,42,39,9,14,10,0,29,3,36,64753,32,23,10,81,1
01,019,00074,0,1,30,96,58,55,12,10,0,64,1,36,167010,65,67,10,154,1
01,019,00075,1,0,0,81,0,23,0,0,2,26,0,0,47594,26,23,2,81,1
01,020,00076,1,0,0,147,0,62,0,0,2,69,0,0,147843,69,62,2,147,1
01,020,00077,0,1,16,118,81,65,33,2,0,60,3,89,166685,63,98,2,199,1
01,021,00078,2,2,50,356,75,136,39,32,10,87,7,65,250421,94,175,42,431,4
01,021,00079,3,7,1185,265,654,122,254,204,8,88,31686,1754,970049,31774,376,212,919,10
01,021,00080,1,1,10,139,111,67,26,3,2,54,6,69,197520,60,93,5,250,2
01,021,00081,0,1,6,69,136,39,43,4,0,42,31,66,111423,73,82,4,205,1
01,022,00082,4,5,86,284,137,111,70,51,5,104,45,182,318444,149,181,56,421,9
02,023,00083,1,0,0,5,0,15,0,0,0,18,0,0,18830,18,15,0,5,1
02,023,00084,3,0,0,10,0,15,0,0,1,38,0,0,78696,38,15,1,10,3
02,023,00085,3,0,0,15,0,22,0,0,1,40,0,0,47809,40,22,1,15,3
02,023,00086,1,0,0,2,0,8,0,0,2,15,0,0,25272,15,8,2,2,1
02,023,00087,0,2,52,12,54,16,23,13,0,18,4,75,46570,22,39,13,66,2
02,023,00088,1,2,52,34,38,29,12,8,0,29,3,56,42810,32,41,8,72,3
02,023,00089,1,0,0,14,0,41,0,0,3,28,0,0,39858,28,41,3,14,1
02,023,00090,1,1,270,95,161,81,25,19,0,101,4,345,179115,105,106,19,256,2
02,023,00091,1,0,0,7,0,7,0,0,0,24,0,0,13886,24,7,0,7,1
02,023,00092,0,0,0,37,0,40,0,0,0,32,0,0,24933,32,40,0,37,0
02,024,00093,0,1,50,120,41,88,14,10,0,86,152,56,175887,238,102,10,161,1
02,024,00094,0,1,30,34,57,28,8,4,0,32,2,36,80985,34,36,4,91,1
02,024,00095,2,0,0,60,0,40,0,0,5,36,0,0,61234,36,40,5,60,2
02,024,00096,1,0,0,102,0,77,0,0,2,69,0,0,112381,69,77,2,102,1
02,024,00097,0,0,0,19,0,15,0,0,0,12,0,0,13670,12,15,0,19,0
02,024,00098,0,0,0,46,0,35,0,0,0,34,0,0,67594,34,35,0,46,0
02,024,00099,0,2,320,75,159,56,31,18,0,57,14,345,136414,71,87,18,234,2
02,024,00100,0,1,50,67,34,51,15,11,0,60,6,50,97474,66,66,11,101,1
02,024,00101,1,1,30,31,20,27,11,6,1,31,6,30,76563,37,38,7,51,2
02,024,00102,0,0,0,26,0,19,0,0,0,15,0,0,25185,15,19,0,26,0
02,024,00103,1,1,100,128,108,95,34,8,3,100,3,320,120505,103,129,11,236,2
02,024,00104,1,1,25,44,20,28,13,4,4,29,7,33,43376,36,41,8,64,2
02,024,00105,1,0,0,53,0,37,0,0,3,28,0,0,32407,28,37,3,53,1
02,024,00106,1,0,0,31,0,18,0,0,4,29,0,0,29441,29,18,4,31,1
02,024,00107,0,0,0,30,0,24,0,0,0,31,0,0,37497,31,24,0,30,0
02,024,00108,1,0,0,29,0,26,0,0,4,61,0,0,19162,61,26,4,29,1
02,024,00109,0,0,0,26,0,24,0,0,0,19,0,0,21696,19,24,0,26,0
02,024,00110,0,0,0,132,0,109,0,0,0,109,0,0,60742,109,109,0,132,0
02,024,00111,9,1,100,287,63,219,19,15,25,152,6,100,188939,158,238,40,350,10
02,024,00112,1,0,0,161,0,101,0,0,8,74,0,0,95086,74,101,8,161,1
02,024,00113,0,0,0,8,0,4,0,0,0,5,0,0,7516,5,4,0,8,0
02,025,00114,0,0,0,35,0,25,0,0,0,20,0,0,8259,20,25,0,35,0
02,025,00115,1,0,0,64,0,34,0,0,5,16,0,0,8537,16,34,5,64,1
02,025,00116,1,0,0,47,0,36,0,0,4,21,0,0,11858,21,36,4,47,1
02,026,00117,3,1,30,11,19,11,15,8,5,17,8,31,51508,25,26,13,30,4
02,026,00118,0,1,200,100,234,81,50,27,0,79,20,295,206465,99,131,27,334,1
02,026,00119,0,0,0,0,0,2,0,0,0,15,0,0,25908,15,2,0,0,0
02,026,00120,1,1,50,28,32,13,10,6,4,28,3,52,43612,31,23,10,60,2
02,026,00121,7,0,0,4,0,7,0,0,0,48,0,0,56917,48,7,0,4,7
02,026,00122,0,0,0,7,0,21,0,0,0,31,0,0,53089,31,21,0,7,0
02,027,00123,0,0,0,12,0,28,0,0,0,20,0,0,49015,20,28,0,12,0
02,027,00124,0,1,100,29,35,45,19,8,0,39,2,153,84179,41,64,8,64,1
02,027,00125,3,0,0,34,0,16,0,0,2,20,0,0,25339,20,16,2,34,3
02,027,00126,1,0,0,12,0,8,0,0,2,6,0,0,16760,6,8,2,12,1
02,027,00127,0,0,0,22,0,18,0,0,0,20,0,0,34768,20,18,0,22,0
02,027,00128,0,0,0,19,0,24,0,0,0,19,0,0,25813,19,24,0,19,0
02,027,00129,0,1,106,38,24,27,10,6,0,32,2,111,64092,34,37,6,62,1
02,027,00130,0,0,0,14,0,8,0,0,0,17,0,0,21415,17,8,0,14,0
02,027,00131,1,0,0,32,0,37,0,0,4,20,0,0,43802,20,37,4,32,1
02,027,00132,1,2,200,59,145,59,23,18,3,54,9,202,111038,63,82,21,204,3
02,027,00133,1,2,321,133,178,119,47,33,2,153,10,433,215654,163,166,35,311,3
02,027,00134,3,0,0,10,0,18,0,0,3,22,0,0,30741,22,18,3,10,3
02,027,00135,0,0,0,20,0,21,0,0,0,18,0,0,37655,18,21,0,20,0
02,027,00136,0,0,0,48,0,32,0,0,0,37,0,0,49831,37,32,0,48,0
02,027,00137,0,0,0,50,0,29,0,0,0,29,0,0,57448,29,29,0,50,0
02,027,00138,0,0,0,20,0,21,0,0,0,23,0,0,34436,23,21,0,20,0
02,027,00139,2,0,0,98,0,52,0,0,0,88,0,0,90568,88,52,0,98,2
02,028,00140,1,1,30,16,6,21,16,4,1,41,3,90,45272,44,37,5,22,2
02,028,00141,0,1,60,41,38,32,7,3,0,36,6,61,79609,42,39,3,79,1
02,028,00142,0,0,0,26,0,18,0,0,0,14,0,0,26740,14,18,0,26,0
02,028,00143,0,1,250,52,84,43,31,20,0,58,14,262,116075,72,74,20,136,1
02,028,00144,0,0,0,41,12,28,5,0,0,36,3,6,54805,39,33,0,53,0
02,028,00145,0,0,0,27,0,12,0,0,0,28,0,0,37323,28,12,0,27,0
02,028,00146,0,0,0,109,0,61,0,0,0,66,0,0,90170,66,61,0,109,0
02,029,00147,1,0,0,36,0,27,0,0,4,26,0,0,17636,26,27,4,36,1
02,029,00148,2,1,16,158,39,108,13,4,4,126,6,46,168424,132,121,8,197,3
02,029,00149,0,0,0,73,0,53,0,0,0,47,0,0,72037,47,53,0,73,0
02,029,00150,1,1,150,108,46,75,18,8,2,87,22,193,190079,109,93,10,154,2
02,029,00151,0,0,0,119,0,83,0,0,0,76,0,0,71416,76,83,0,119,0
02,030,00152,0,1,50,20,38,25,10,7,0,38,6,50,89339,44,35,7,58,1
02,030,00153,0,0,0,37,0,28,0,0,0,27,0,0,45558,27,28,0,37,0
02,030,00154,0,0,0,53,11,40,5,0,0,40,4,15,91098,44,45,0,64,0
02,030,00155,1,0,0,15,6,27,5,0,3,41,3,10,46364,44,32,3,21,1
02,030,00156,0,1,225,38,252,38,31,21,0,35,4,280,75474,39,69,21,290,1
02,030,00157,0,0,0,35,0,25,0,0,0,22,0,0,32717,22,25,0,35,0
02,031,00158,3,1,50,41,9,29,11,9,5,20,1,50,55105,21,40,14,50,4
02,031,00159,2,0,0,38,0,31,0,0,4,22,0,0,35959,22,31,4,38,2
02,031,00160,0,0,0,10,0,15,0,0,0,31,0,0,31789,31,15,0,10,0
02,031,00161,0,1,100,63,75,58,21,12,0,63,7,111,113510,70,79,12,138,1
02,031,00162,1,1,4,33,5,55,2,2,8,50,8,4,89748,58,57,10,38,2
02,031,00163,0,0,0,23,0,21,0,0,0,15,0,0,22546,15,21,0,23,0
02,031,00164,2,2,69,49,83,39,19,10,4,37,9,90,65648,46,58,14,132,4
02,031,00165,0,3,210,49,140,34,54,43,0,31,9,272,112760,40,88,43,189,3
02,031,00166,1,0,0,40,0,28,0,0,2,27,0,0,38517,27,28,2,40,1
02,032,00167,4,1,50,20,15,14,9,6,3,30,3,50,48927,33,23,9,35,5
02,032,00168,0,0,0,19,0,17,0,0,0,21,0,0,22994,21,17,0,19,0
02,032,00169,2,0,0,13,0,16,0,0,0,31,0,0,52922,31,16,0,13,2
02,032,00170,0,0,0,11,0,11,0,0,0,47,0,0,47388,47,11,0,11,0
02,032,00171,1,0,0,6,0,6,0,0,1,9,0,0,17172,9,6,1,6,1
02,032,00172,2,1,318,28,79,34,52,36,2,27,8,368,83944,35,86,38,107,3
02,032,00173,1,1,50,33,64,41,24,16,1,48,5,60,157799,53,65,17,97,2
02,032,00174,0,0,0,14,0,17,0,0,0,18,0,0,37032,18,17,0,14,0
02,032,00175,0,0,0,16,0,26,0,0,0,20,0,0,36905,20,26,0,16,0
02,032,00176,0,0,0,11,0,13,0,0,0,12,0,0,23324,12,13,0,11,0
02,033,00177,2,2,120,89,25,72,23,21,8,68,2,130,77439,70,95,29,114,4
02,033,00178,0,0,0,13,0,14,0,0,0,17,0,0,26055,17,14,0,13,0
02,033,00179,1,1,15,13,4,38,1,1,1,36,3,15,42750,39,39,2,17,2
02,033,00180,0,1,28,15,25,21,8,5,0,20,4,28,34499,24,29,5,40,1
02,033,00181,0,1,130,65,146,58,15,12,0,53,2,136,80715,55,73,12,211,1
02,033,00182,0,4,1550,0,406,0,310,140,0,0,42,1780,169578,42,310,140,406,4
02,033,00183,2,0,0,10,0,11,0,0,0,12,0,0,13200,12,11,0,10,2
02,033,00184,0,1,50,65,21,54,14,8,0,46,6,52,82389,52,68,8,86,1
02,033,00185,0,1,20,10,6,17,3,3,0,28,4,20,30713,32,20,3,16,1
02,033,00186,0,0,0,14,0,16,0,0,0,19,0,0,19372,19,16,0,14,0
02,033,00187,0,0,0,13,0,16,0,0,0,15,0,0,35835,15,16,0,13,0
02,033,00188,0,1,50,14,17,26,8,5,0,21,2,50,37348,23,34,5,31,1
02,033,00189,0,1,80,51,8,51,5,4,0,50,1,83,38524,51,56,4,59,1
02,033,00190,0,0,0,8,0,13,0,0,0,13,0,0,13608,13,13,0,8,0
02,033,00191,0,1,150,18,38,19,12,7,0,23,3,150,49021,26,31,7,56,1
02,033,00192,0,0,0,28,0,25,0,0,0,21,0,0,46000,21,25,0,28,0
02,033,00193,0,0,0,5,0,2,0,0,0,6,0,0,6358,6,2,0,5,0
02,034,00194,1,0,0,5,0,3,0,0,1,7,0,0,4574,7,3,1,5,1
02,034,00195,0,0,0,38,0,25,0,0,0,18,0,0,8123,18,25,0,38,0
02,034,00196,0,0,0,18,0,15,0,0,0,16,0,0,10056,16,15,0,18,0
02,034,00197,2,0,0,11,0,20,0,0,2,14,0,0,19103,14,20,2,11,2
02,034,00198,2,0,0,26,0,27,0,0,2,26,0,0,27461,26,27,2,26,2
02,034,00199,0,0,0,12,0,7,0,0,0,16,0,0,13940,16,7,0,12,0
03,035,00200,0,0,0,30,0,23,0,0,0,26,0,0,54186,26,23,0,30,0
03,035,00201,5,10,247,236,132,165,42,30,10,164,47,259,622111,211,207,40,368,15
03,035,00202,9,3,156,322,431,269,115,27,10,218,89,758,821202,307,384,37,753,12
03,035,00203,6,5,155,206,312,182,66,35,6,154,661,283,675817,815,248,41,518,11
03,035,00204,1,1,30,37,19,29,5,3,1,29,5,82,124295,34,34,4,56,2
03,036,00205,2,2,16,29,26,18,18,7,2,27,5,56,104020,32,36,9,55,4
03,036,00206,24,1,100,338,101,332,14,2,24,264,77,118,341306,341,346,26,439,25
03,036,00207,2,7,100,59,154,58,57,10,2,50,1071,422,121212,1121,115,12,213,9
03,036,00208,2,2,150,79,61,67,22,18,2,61,57,180,247216,118,89,20,140,4
03,037,00209,2,2,60,135,42,73,11,10,2,80,301,60,166436,381,84,12,177,4
03,037,00210,5,1,50,242,20,146,17,14,22,89,2,50,208113,91,163,36,262,6
03,037,00211,7,5,120,194,127,162,33,26,15,178,196,150,381616,374,195,41,321,12
03,037,00212,3,21,692,214,390,134,156,73,6,91,192,898,1145593,283,290,79,604,24
03,037,00213,6,1,30,160,88,145,48,7,6,114,151,210,290379,265,193,13,248,7
03,038,00214,45,2,130,568,69,570,25,18,45,554,8783,154,360377,9337,595,63,637,47
03,038,00215,9,1,50,185,70,188,22,10,9,485,8,163,334949,493,210,19,255,10
03,038,00216,7,4,293,186,144,174,89,51,7,174,73,354,560098,247,263,58,330,11
03,038,00217,20,2,80,381,64,377,23,12,20,434,186,270,330518,620,400,32,445,22
03,039,00218,9,2,94,292,46,223,26,17,12,193,53,103,423378,246,249,29,338,11
03,039,00219,4,1,30,140,60,99,12,11,5,95,8,30,188596,103,111,16,200,5
03,040,00220,0,1,30,15,33,15,13,7,0,52,7,65,96134,59,28,7,48,1
03,040,00221,0,5,240,4,131,2,86,69,0,3,271,442,202236,274,88,69,135,5
03,040,00222,0,2,80,31,57,22,32,18,0,22,15,185,210609,37,54,18,88,2
03,040,00223,0,1,30,29,13,18,6,6,0,21,19,30,91038,40,24,6,42,1
03,041,00224,1,2,80,76,68,68,23,20,1,64,17,80,223251,81,91,21,144,3
03,041,00225,0,2,114,79,82,75,3,0,0,57,1241,116,222297,1298,78,0,161,2
03,041,00226,7,2,60,124,70,96,18,15,7,77,162,60,213541,239,114,22,194,9
03,041,00227,7,2,155,169,341,132,92,38,8,107,1794,296,1934108,1901,224,46,510,9
03,041,00228,2,0,0,77,6,70,3,0,2,57,19,8,362560,76,73,2,83,2
03,041,00229,2,1,30,102,67,103,12,9,2,73,13,52,201451,86,115,11,169,3
03,041,00230,6,1,50,215,13,211,15,14,6,139,20,60,341195,159,226,20,228,7
03,042,00231,5,1,30,121,11,84,1,1,5,75,3,30,170609,78,85,6,132,6
03,042,00232,1,1,30,65,11,56,6,4,1,58,9,30,225649,67,62,5,76,2
03,042,00233,11,4,170,276,152,197,42,28,11,185,69,208,599286,254,239,39,428,15
03,043,00234,5,3,63,125,79,114,17,12,8,147,18,68,258273,165,131,20,204,8
03,043,00235,6,8,131,322,114,314,33,21,6,300,105,158,566981,405,347,27,436,14
03,043,00236,3,2,42,98,82,99,12,12,3,83,23,42,355984,106,111,15,180,5
03,043,00237,8,2,50,168,49,138,14,11,13,117,356,50,404152,473,152,24,217,10
03,043,00238,3,1,100,112,73,88,26,18,4,84,34,106,443266,118,114,22,185,4
03,044,00239,6,1,50,203,31,144,10,10,11,91,6,50,348165,97,154,21,234,7
03,044,00240,2,1,50,94,29,88,6,6,2,55,3,50,222937,58,94,8,123,3
03,044,00241,5,2,85,114,80,81,19,13,6,70,33,113,330685,103,100,19,194,7
03,045,00242,5,3,650,143,179,101,222,204,5,107,60,698,456569,167,323,209,322,8
03,045,00243,4,1,30,112,23,74,9,6,4,195,16,30,160930,211,83,10,135,5
03,046,00244,4,2,80,166,70,106,40,14,4,85,29,232,316669,114,146,18,236,6
03,046,00245,2,3,134,297,313,196,62,31,2,142,376,288,755899,518,258,33,610,5
03,046,00246,1,3,85,187,99,157,21,13,1,104,56,119,315930,160,178,14,286,4
03,047,00247,1,1,50,57,44,42,6,5,1,38,5,50,174233,43,48,6,101,2
03,047,00248,1,0,0,170,83,103,6,0,1,74,12,40,254706,86,109,1,253,1
03,047,00249,2,1,100,170,121,119,27,19,2,92,37,130,340811,129,146,21,291,3
03,048,00250,2,6,25,22,38,21,4,1,2,20,85,25,173970,105,25,3,60,8
03,048,00251,0,1,30,20,25,20,6,5,0,17,15,30,193683,32,26,5,45,1
03,048,00252,2,2,80,95,119,88,17,9,2,87,35,110,277186,122,105,11,214,4
03,048,00253,5,7,1072,192,1441,192,74,15,5,169,103,1433,859674,272,266,20,1633,12
03,048,00254,6,2,80,113,80,107,29,23,6,153,35,84,390933,188,136,29,193,8
03,049,00255,6,3,57,216,106,170,39,19,6,159,20,116,442652,179,209,25,322,9
03,049,00256,3,1,30,109,36,79,11,6,3,90,44,48,308633,134,90,9,145,4
03,049,00257,2,44,1722,130,992,118,136,70,2,99,876,2192,1415214,975,254,72,1122,46
03,049,00258,8,1,30,89,20,81,13,6,11,79,8,181,320449,87,94,17,109,9
03,050,00259,14,1,50,204,71,166,2,1,14,182,63,51,493617,245,168,15,275,15
03,050,00260,5,3,111,141,48,123,36,18,5,108,68,158,438112,176,159,23,189,8
03,050,00261,44,0,0,187,0,187,0,0,24,351,0,0,187768,351,187,24,187,44
03,051,00262,3,1,100,146,59,101,32,15,4,87,14,170,194344,101,133,19,205,4
03,051,00263,1,2,100,58,65,40,22,17,1,29,6,146,133585,35,62,18,123,3
03,051,00264,0,1,100,76,86,48,34,20,0,38,216,104,181154,254,82,20,162,1
03,051,00265,0,2,55,71,98,55,13,8,0,15,17,67,175043,32,68,8,169,2
03,052,00266,0,2,80,283,59,148,29,21,0,67,26,102,329684,93,177,21,342,2
03,052,00267,0,2,100,61,104,60,52,27,0,44,44,100,324339,88,112,27,165,2
03,052,00268,0,1,30,78,104,70,25,7,0,67,177,52,340490,244,95,7,182,1
03,053,00269,2,3,160,109,136,91,36,29,2,64,38,193,429627,102,127,31,245,5
03,053,00270,0,0,0,76,0,69,11,0,0,59,10,40,261247,69,80,0,76,0
03,053,00271,2,3,160,137,109,116,38,20,2,86,27080,255,362834,27166,154,22,246,5
03,053,00272,1,9,99,106,105,106,12,12,1,70,45,101,334617,115,118,13,211,10
03,053,00273,1,1,30,17,12,16,5,5,1,12,18,31,132382,30,21,6,29,2
03,053,00274,1,2,34,58,29,57,3,1,1,40,9,37,134218,49,60,2,87,3
03,054,00275,6,2,130,148,126,91,27,20,6,79,20,137,388692,99,118,26,274,8
03,054,00276,2,2,38,128,79,53,20,5,2,42,13,65,206828,55,73,7,207,4
04,055,00277,0,6,2894,24,3349,13,747,611,0,13,109,2894,1055450,122,760,611,3373,6
05,056,00278,1,0,0,31,0,11,0,0,1,9,0,0,33701,9,11,1,31,1
05,056,00279,3,0,0,69,0,22,0,0,4,34,0,0,40389,34,22,4,69,3
05,056,00280,6,1,30,101,13,31,3,2,7,39,3,38,70259,42,34,9,114,7
05,056,00281,3,0,0,70,0,22,0,0,4,26,0,0,60134,26,22,4,70,3
05,056,00282,3,0,0,53,0,15,0,0,4,23,0,0,49791,23,15,4,53,3
05,056,00283,5,2,98,68,102,24,18,11,5,31,12,110,74955,43,42,16,170,7
05,057,00284,2,3,50,41,37,19,16,7,3,21,4,53,47869,25,35,10,78,5
05,057,00285,5,2,85,127,115,45,30,16,5,36,16,156,99339,52,75,21,242,7
05,057,00286,0,0,0,16,0,3,0,0,0,11,0,0,35303,11,3,0,16,0
05,057,00287,1,2,33,42,27,6,7,5,1,17,7,33,54942,24,13,6,69,3
05,057,00288,10,0,0,138,0,50,0,0,12,45,0,0,87874,45,50,12,138,10
05,057,00289,2,0,0,53,0,14,0,0,2,21,0,0,61805,21,14,2,53,2
05,058,00290,8,1,4,167,3,76,1,1,9,66,1,4,86339,67,77,10,170,9
05,058,00291,9,1,72,128,58,53,14,9,10,56,5,100,91166,61,67,19,186,10
05,058,00292,4,0,0,95,0,51,0,0,7,36,0,0,63225,36,51,7,95,4
05,059,00293,5,0,0,166,0,44,0,0,5,56,0,0,120398,56,44,5,166,5
05,059,00294,5,2,19,127,27,35,7,3,5,46,4,23,92890,50,42,8,154,7
05,059,00295,5,0,0,99,0,21,0,0,5,48,0,0,73516,48,21,5,99,5
05,059,00296,4,0,0,58,0,15,0,0,4,23,0,0,32137,23,15,4,58,4
05,059,00297,4,3,88,98,83,18,17,10,4,32,12,123,116571,44,35,14,181,7
05,059,00298,3,0,0,80,0,24,0,0,3,31,0,0,73654,31,24,3,80,3
05,059,00299,4,1,24,168,57,59,15,11,4,50,10,44,104745,60,74,15,225,5
05,060,00300,4,1,14,76,32,19,8,5,4,28,7,14,49606,35,27,9,108,5
05,060,00301,14,0,0,232,0,82,0,0,14,91,0,0,33897,91,82,14,232,14
05,060,00302,15,0,0,120,0,30,0,0,13,48,0,0,47116,48,30,13,120,15
05,060,00303,4,3,33,352,50,82,14,12,7,80,20,34,317368,100,96,19,402,7
05,060,00304,1,14,802,224,1708,49,359,125,1,53,196,2283,987741,249,408,126,1932,15
05,060,00305,6,3,300,162,129,67,17,14,7,52,35,305,260091,87,84,21,291,9
05,061,00306,19,1,54,168,33,53,10,5,21,49,5,58,52291,54,63,26,201,20
05,061,00307,15,1,132,233,97,78,15,8,15,106,7,190,130774,113,93,23,330,16
05,061,00308,10,0,0,308,0,66,0,0,10,223,0,0,91000,223,66,10,308,10
05,061,00309,22,0,0,526,0,166,0,0,22,319,0,0,37169,319,166,22,526,22
05,061,00310,9,1,33,499,13,50,2,2,10,403,2,33,74911,405,52,12,512,10
05,061,00311,3,0,0,221,0,24,0,0,3,175,0,0,29383,175,24,3,221,3
05,061,00312,6,0,0,209,0,41,0,0,6,142,0,0,36661,142,41,6,209,6
05,061,00313,9,2,110,123,100,44,35,22,10,96,6,133,173712,102,79,32,223,11
05,061,00314,8,1,5,61,16,19,2,1,9,34,4,15,42329,38,21,10,77,9
05,062,00315,3,0,0,59,0,12,0,0,3,35,0,0,45185,35,12,3,59,3
05,062,00316,7,1,30,57,21,25,6,4,8,29,5,33,65637,34,31,12,78,8
05,062,00317,14,6,50,161,18,49,10,5,17,58,8,117,78804,66,59,22,179,20
05,062,00318,4,0,0,54,0,12,0,0,6,23,0,0,50104,23,12,6,54,4
05,062,00319,5,0,0,64,0,20,0,0,5,38,0,0,70038,38,20,5,64,5
05,062,00320,6,6,144,106,144,23,12,1,8,42,14,250,165741,56,35,9,250,12
05,063,00321,4,0,0,64,0,39,0,0,5,50,0,0,64608,50,39,5,64,4
05,063,00322,3,0,0,22,0,12,0,0,4,14,0,0,25194,14,12,4,22,3
05,063,00323,5,1,60,73,46,30,17,11,5,51,7,64,98456,58,47,16,119,6
05,063,00324,3,0,0,70,0,35,0,0,4,54,0,0,68283,54,35,4,70,3
05,064,00325,6,0,0,124,0,33,0,0,6,33,0,0,69183,33,33,6,124,6
05,064,00326,2,0,0,45,0,12,0,0,2,13,0,0,45707,13,12,2,45,2
05,064,00327,4,0,0,73,0,15,0,0,4,24,0,0,56481,24,15,4,73,4
05,064,00328,5,4,245,78,58,18,14,10,5,24,13,247,99170,37,32,15,136,9
05,064,00329,6,0,0,69,0,22,0,0,6,22,1,0,54360,23,22,6,69,6
05,064,00330,10,2,215,209,183,62,28,21,12,48,13,220,163239,61,90,33,392,12
05,064,00331,3,0,0,76,0,16,0,0,3,22,0,0,39871,22,16,3,76,3
05,064,00332,2,0,0,43,0,11,0,0,2,10,0,0,30705,10,11,2,43,2
05,064,00333,2,0,0,56,0,10,0,0,2,21,0,0,56894,21,10,2,56,2
05,065,00334,4,1,30,40,32,15,11,3,4,21,6,54,53989,27,26,7,72,5
05,065,00335,2,0,0,44,0,14,0,0,2,21,0,0,45012,21,14,2,44,2
05,065,00336,2,1,30,93,13,39,11,0,2,35,4,53,85809,39,50,2,106,3
05,065,00337,1,2,40,79,32,17,13,11,1,31,15,46,72887,46,30,12,111,3
05,066,00338,5,0,0,67,0,40,0,0,7,64,0,0,30965,64,40,7,67,5
05,066,00339,0,0,0,16,0,6,0,0,0,38,0,0,20958,38,6,0,16,0
05,066,00340,4,4,151,126,191,85,53,31,7,169,16,206,149663,185,138,38,317,8
05,066,00341,9,0,0,121,0,75,0,0,16,167,0,0,78541,167,75,16,121,9
05,066,00342,5,3,758,93,409,54,236,221,6,168,95,806,363911,263,290,227,502,8
05,066,00343,5,1,60,82,57,51,17,13,11,141,8,83,153363,149,68,24,139,6
05,066,00344,3,1,4,54,18,34,4,1,9,77,2,8,59767,79,38,10,72,4
05,066,00345,0,1,4,29,5,17,1,1,0,56,2,4,94724,58,18,1,34,1
05,067,00346,0,1,66,44,57,9,25,17,0,174,33,91,283136,207,34,17,101,1
05,067,00347,1,1,30,38,37,9,9,6,2,156,3,46,170232,159,18,8,75,2
05,067,00348,2,2,34,58,61,20,21,19,3,207,7,49,187862,214,41,22,119,4
05,067,00349,0,3,180,73,155,16,55,35,0,201,57,216,390763,258,71,35,228,3
05,067,00350,1,2,34,29,24,8,8,4,1,174,11,40,174848,185,16,5,53,3
05,067,00351,2,1,30,96,32,21,6,3,4,288,4,38,214319,292,27,7,128,3
05,067,00352,2,1,30,95,23,20,10,8,3,238,20,30,227163,258,30,11,118,3
05,068,00353,0,10,198,322,382,113,87,33,0,956,101,444,996129,1057,200,33,704,10
05,068,00354,0,10,530,122,390,34,101,79,0,455,116,561,657635,571,135,79,512,10
05,068,00355,0,1,30,85,63,21,3,2,0,464,2,30,236198,466,24,2,148,1
06,069,00356,0,2,39,36,56,8,19,16,0,18,16,39,168061,34,27,16,92,2
06,069,00357,0,3,186,83,278,33,77,71,0,53,45,186,393207,98,110,71,361,3
06,070,00358,0,1,50,84,23,25,10,9,0,119,17,50,228633,136,35,9,107,1
06,070,00359,0,4,302,97,249,22,74,53,0,44,187,338,655561,231,96,53,346,4
06,070,00360,0,2,32,124,27,33,8,6,0,78,38,34,243978,116,41,6,151,2
06,071,00361,0,5,192,157,138,49,91,78,0,164,100,192,853431,264,140,78,295,5
06,071,00362,0,2,20,48,39,18,7,5,0,76,12,20,186409,88,25,5,87,2
06,071,00363,0,1,6,53,10,15,3,2,0,27,2,6,174111,29,18,2,63,1
06,072,00364,0,1,30,27,47,7,10,8,0,17,12,30,130176,29,17,8,74,1
06,072,00365,0,2,36,86,59,34,12,9,0,61,19,36,255307,80,46,9,145,2
06,072,00366,0,2,130,249,214,76,84,33,0,92,29,230,579118,121,160,33,463,2
06,073,00367,0,1,25,71,30,13,6,5,0,32,5,25,195251,37,19,5,101,1
06,073,00368,0,2,130,274,143,58,23,20,0,107,21,130,641973,128,81,20,417,2
06,073,00369,0,1,10,133,21,30,3,2,0,59,30,10,237044,89,33,2,154,1
06,074,00370,0,2,38,59,64,18,11,9,0,52,13,38,207083,65,29,9,123,2
06,074,00371,0,1,30,44,28,9,5,4,0,27,10,30,162455,37,14,4,72,1
06,074,00372,0,2,230,128,308,28,41,36,0,63,114,252,714300,177,69,36,436,2
06,074,00373,0,1,30,105,43,26,9,8,0,72,10,30,233204,82,35,8,148,1
06,074,00374,0,1,20,51,22,10,5,4,0,30,11,20,188032,41,15,4,73,1
06,075,00375,0,3,183,111,119,28,44,27,0,71,109,184,791613,180,72,27,230,3
06,075,00376,0,0,0,75,0,23,0,0,0,41,0,0,108196,41,23,0,75,0
06,075,00377,0,1,30,114,33,37,8,7,0,97,10,30,305607,107,45,7,147,1
06,076,00378,1,1,30,341,63,264,12,9,225,123,21,32,372034,144,276,234,404,2
06,076,00379,0,1,30,80,45,13,9,7,0,37,9,30,206855,46,22,7,125,1
06,076,00380,0,1,100,282,152,37,46,40,0,85,77,100,710159,162,83,40,434,1
06,076,00381,0,1,24,108,37,26,5,4,0,41,11,24,160895,52,31,4,145,1
06,077,00382,0,2,150,219,112,70,13,11,0,77,9,154,484301,86,83,11,331,2
06,077,00383,0,1,100,223,134,84,31,28,0,68,29,110,476794,97,115,28,357,1
06,077,00384,0,1,30,68,56,23,5,4,0,22,6,30,119408,28,28,4,124,1
06,077,00385,0,1,50,142,16,58,8,4,0,48,11,60,253629,59,66,4,158,1
06,078,00386,0,1,30,29,20,1,5,4,0,28,18,30,179550,46,6,4,49,1
06,078,00387,0,2,110,80,76,22,19,16,0,37,42,120,263678,79,41,16,156,2
06,078,00388,0,1,100,160,50,45,47,42,0,98,17,100,498697,115,92,42,210,1
06,079,00389,1,1,60,152,32,35,8,7,5,81,19,60,269929,100,43,12,184,2
06,079,00390,0,2,112,284,148,92,28,18,0,143,77,122,717279,220,120,18,432,2
06,079,00391,0,1,30,64,12,19,4,3,0,37,7,30,175664,44,23,3,76,1
06,079,00392,0,1,30,34,26,9,5,4,0,17,10,30,132266,27,14,4,60,1
06,080,00393,0,1,50,79,23,24,6,5,0,27,7,50,146952,34,30,5,102,1
06,080,00394,0,3,254,379,272,99,76,51,0,201,148,329,1069309,349,175,51,651,3
06,080,00395,0,1,30,54,35,9,7,3,0,32,24,30,140880,56,16,3,89,1
06,080,00396,0,1,60,240,56,36,13,10,0,69,20,62,386790,89,49,10,296,1
06,081,00397,0,1,30,47,22,9,4,3,0,30,5,30,126990,35,13,3,69,1
06,081,00398,0,1,400,205,374,56,57,45,0,82,71,425,553698,153,113,45,579,1
06,081,00399,0,1,30,135,19,24,6,5,0,37,5,30,191443,42,30,5,154,1
06,081,00400,0,1,25,52,16,10,7,6,0,12,5,25,100183,17,17,6,68,1
06,081,00401,0,1,50,77,18,17,6,5,0,30,6,50,159787,36,23,5,95,1
06,081,00402,0,1,50,237,26,54,9,8,0,78,27,50,384192,105,63,8,263,1
06,081,00403,0,0,0,99,0,25,0,0,0,42,0,0,118084,42,25,0,99,0
06,082,00404,0,1,30,152,9,25,7,6,0,52,10,30,203050,62,32,6,161,1
06,082,00405,0,3,1831,297,832,63,407,399,0,94,111,1831,734328,205,470,399,1129,3
06,082,00406,0,1,30,73,45,10,7,4,0,25,18,30,123826,43,17,4,118,1
06,083,00407,0,1,15,131,34,30,3,2,0,41,14,15,155791,55,33,2,165,1
06,083,00408,0,1,30,151,86,47,33,25,0,79,27,30,403717,106,80,25,237,1
06,083,00409,0,1,100,138,65,46,24,22,0,85,20,100,258559,105,70,22,203,1
06,083,00410,0,0,0,88,0,40,0,0,0,39,0,0,140273,39,40,0,88,0
06,084,00411,0,2,62,175,43,53,11,8,0,75,22,62,404328,97,64,8,218,2
06,084,00412,0,3,146,160,114,52,30,21,0,96,40,177,517707,136,82,21,274,3
06,085,00413,0,0,0,94,2,25,0,0,0,31,6,0,127407,37,25,0,96,0
06,085,00414,0,2,110,252,117,55,38,29,0,112,84,118,642789,196,93,29,369,2
06,085,00415,0,1,30,32,42,8,7,5,0,33,9,33,130050,42,15,5,74,1
06,086,00416,0,2,54,50,34,19,12,10,0,19,19,54,120012,38,31,10,84,2
06,086,00417,0,3,312,35,132,9,71,57,0,17,99,317,977333,116,80,57,167,3
06,086,00418,0,1,24,57,20,16,8,6,0,23,6,24,134848,29,24,6,77,1
06,086,00419,0,0,0,21,2,6,0,0,0,34,5,0,116575,39,6,0,23,0
06,086,00420,0,2,40,47,66,10,13,11,0,16,15,40,165629,31,23,11,113,2
06,087,00421,0,1,8,22,15,8,5,3,0,17,9,10,166744,26,13,3,37,1
06,087,00422,0,1,24,35,13,11,7,5,0,33,5,24,287101,38,18,5,48,1
06,087,00423,1,2,30,85,33,57,9,7,41,40,9,30,343406,49,66,48,118,3
06,087,00424,0,2,38,27,17,5,8,6,0,26,10,38,291926,36,13,6,44,2
06,088,00425,0,3,500,33,359,14,178,112,0,49,258,540,1594839,307,192,112,392,3
06,088,00426,0,0,0,60,2,27,0,0,0,72,2,0,214804,74,27,0,62,0
06,089,00427,0,1,50,94,54,29,5,3,0,53,28,50,506208,81,34,3,148,1
06,089,00428,0,1,30,57,19,14,6,5,0,48,4,30,269015,52,20,5,76,1
06,089,00429,0,2,34,53,58,10,11,9,0,43,12,34,267437,55,21,9,111,2
07,090,00430,0,4,190,84,502,39,178,94,0,28,44,336,548409,72,217,94,586,4
07,090,00431,0,1,123.6363639831543,14,176,8,66.5151538848877,31.93939399719238,0,8,227,235.8181762695313,822136,235,74.515152,31.939394,190,1
07,090,00432,0,2,100,0,301,0,110,83,0,0,23,190,197148,23,110,83,301,2
07,091,00433,0,0,0,0,51,0,7.25,0,0,0,16,54,287035,16,7.25,0,51,0
07,092,00436,0,0,0,5,216,4,57,0,0,3,28,212.6666698455811,847941,31,61,0,221,0
07,092,00437,0,0,0,0,41,0,15,0,0,0,14,18,91659,14,15,0,41,0
07,092,00438,0,0,0,0,50,0,7,0,0,0,12,38.53333282470703,120417,12,7,0,50,0
07,093,00439,0,0,0,0,0,0,0,0,0,0,0,0,1178,0,0,0,0,0
07,093,00441,0,6,340,1,584,1,250,76,0,1,54,873,421904,55,251,76,585,6
07,096,00448,0,0,0,0,20,0,6.363636016845703,0,0,0,5,23.45454406738281,196189,5,6.363636,0,20,0
07,096,00450,0,0,0,11,184,7,26.3636360168457,0,0,2,21,178.3636322021484,467791,23,33.363636,0,195,0
07,097,00451,1,1,100,91,141,73,115,86,1,34,32,131,337930,66,188,87,232,2
07,097,00452,0,1,50,0,59,0,16,8,0,0,4,60,21502,4,16,8,59,1
07,097,00453,0,0,0,0,32,0,10,0,0,0,10,11,165944,10,10,0,32,0
07,098,00454,0,2,123.1304349899292,0,196,0,64.43478226661682,14.60869562625885,0,3,36,218.0869560241699,454314,39,64.434784,14.608696,196,2
07,098,00455,0,0,0,0,0,0,0,0,0,0,0,0,10168,0,0,0,0,0
07,098,00456,0,0,0,0,26,0,13,0,0,0,28,0,393567,28,13,0,26,0
08,099,00457,0,3,80,161,65,31,22,6,0,80,12,114,146293,92,53,6,226,3
08,099,00458,0,4,305,348,142,85,83,57,0,123,28,331,480911,151,168,57,490,4
08,099,00459,0,4,56,163,65,42,24,5,0,65,10,88,157521,75,66,5,228,4
08,099,00460,0,3,110,157,77,42,26,10,0,68,14,143,162327,82,68,10,234,3
08,099,00461,0,1,50,123,34,8,15,8,0,70,6,67,195515,76,23,8,157,1
08,099,00462,0,2,50,97,53,7,14,4,0,46,8,65,183292,54,21,4,150,2
08,099,00463,0,2,76,60,110,9,19,4,0,28,12,121,170552,40,28,4,170,2
08,099,00464,0,2,100,72,45,5,17,4,0,36,12,118,145233,48,22,4,117,2
08,099,00465,0,2,40,204,35,46,25,13,0,75,8,60,319322,83,71,13,239,2
08,100,00466,0,1,50,156,35,67,15,8,0,57,8,61,157914,65,82,8,191,1
08,100,00467,0,0,0,154,0,46,0,0,0,61,0,0,164170,61,46,0,154,0
08,100,00468,0,2,180,365,93,110,44,29,0,93,17,203,422874,110,154,29,458,2
08,100,00469,0,1,30,162,25,55,11,4,0,55,6,41,214224,61,66,4,187,1
08,100,00470,0,1,50,151,48,32,14,8,0,59,5,61,204164,64,46,8,199,1
08,100,00471,0,1,50,378,39,125,13,6,0,116,6,61,313963,122,138,6,417,1
08,100,00472,1,1,50,425,82,120,11,4,4,119,5,61,289801,124,131,8,507,2
08,101,00473,0,9,1920,370,1374,120,356,276,0,94,71,2126,919691,165,476,276,1744,9
08,101,00474,0,0,0,82,0,17,0,0,0,33,0,0,67163,33,17,0,82,0
08,101,00475,0,0,0,258,0,71,0,0,0,86,0,0,213509,86,71,0,258,0
08,101,00476,0,1,45,350,38,95,9,3,0,127,4,50,260659,131,104,3,388,1
08,101,00477,0,2,110,466,73,157,37,25,0,130,6,130,436840,136,194,25,539,2
08,101,00478,0,1,50,95,28,23,14,9,0,36,3,55,88730,39,37,9,123,1
08,101,00479,0,0,0,65,0,19,0,0,0,25,0,0,82488,25,19,0,65,0
08,101,00480,0,5,85,350,50,118,24,5,0,102,18,116,294294,120,142,5,400,5
08,102,00481,0,2,40,261,42,70,16,7,0,92,7,56,211785,99,86,7,303,2
08,102,00482,0,1,150,349,18,78,10,4,0,141,9,161,362537,150,88,4,367,1
08,102,00483,0,1,80,293,39,86,18,10,0,97,7,95,382450,104,104,10,332,1
08,102,00484,0,4,325,296,145,69,70,45,0,101,31,364,310515,132,139,45,441,4
08,102,00485,0,4,136,286,154,71,38,16,0,89,19,196,292012,108,109,16,440,4
08,102,00486,1,6,207,445,141,137,48,19,4,136,23,262,479954,159,185,23,586,7
08,103,00487,0,11,371,429,334,88,121,56,0,161,50,485,538174,211,209,56,763,11
08,103,00488,0,13,391,557,246,125,110,18,0,161,65,480,476085,226,235,18,803,13
08,103,00489,0,1,5,292,19,61,8,2,0,106,4,10,223405,110,69,2,311,1
08,103,00490,0,5,169,434,137,120,63,36,0,127,15,200,277946,142,183,36,571,5
08,103,00491,1,7,207,445,109,127,46,10,4,128,27,258,326663,155,173,14,554,8
08,103,00492,0,1,31,511,38,141,10,3,0,132,4,42,294770,136,151,3,549,1
08,104,00493,0,4,115,409,104,131,36,13,0,118,12,172,359229,130,167,13,513,4
08,104,00494,1,0,0,268,0,75,0,0,4,76,0,0,231628,76,75,4,268,1
08,104,00495,1,0,0,113,0,26,0,0,4,36,0,0,137339,36,26,4,113,1
08,104,00496,0,3,106,181,107,48,33,13,0,57,26,140,396532,83,81,13,288,3
08,104,00497,0,2,175,124,77,30,27,13,0,31,7,190,201279,38,57,13,201,2
08,104,00498,0,1,60,182,24,57,11,5,0,49,4,65,256532,53,68,5,206,1
08,104,00499,0,5,492,400,475,137,117,68,0,129,56,518,703856,185,254,68,875,5
08,104,00500,0,0,0,291,0,91,0,0,0,80,0,0,263663,80,91,0,291,0
08,104,00501,0,0,0,252,0,69,0,0,0,69,0,0,233346,69,69,0,252,0
08,104,00502,0,2,55,433,45,116,22,10,0,132,9,70,356680,141,138,10,478,2
08,104,00503,1,1,55,236,26,74,12,5,6,69,3,60,288671,72,86,11,262,2
08,104,00504,0,1,30,215,45,70,8,2,0,59,7,40,245159,66,78,2,260,1
08,105,00505,0,0,0,189,0,63,0,0,0,46,0,0,198841,46,63,0,189,0
08,105,00506,0,2,50,122,65,42,15,4,0,30,8,66,203942,38,57,4,187,2
08,105,00507,0,1,30,189,31,49,13,4,0,62,4,35,241857,66,62,4,220,1
08,105,00508,0,2,55,225,57,57,14,4,0,62,8,70,226701,70,71,4,282,2
08,105,00509,0,2,30,176,31,53,14,3,0,49,9,45,215136,58,67,3,207,2
08,105,00510,0,1,30,263,36,66,12,5,0,82,5,40,201274,87,78,5,299,1
08,105,00511,0,4,600,174,194,47,106,86,0,58,23,641,452867,81,153,86,368,4
08,105,00512,0,3,50,293,51,81,24,7,0,68,12,70,280083,80,105,7,344,3
08,105,00513,0,3,105,172,74,43,23,7,0,60,9,171,269426,69,66,7,246,3
08,105,00514,0,0,0,254,0,81,0,0,0,74,0,0,257936,74,81,0,254,0
08,106,00515,0,1,60,136,55,45,10,4,0,40,4,65,244738,44,55,4,191,1
08,106,00516,0,2,100,105,79,22,22,11,0,44,8,120,245617,52,44,11,184,2
08,106,00517,0,0,0,159,0,46,0,0,0,48,0,0,191078,48,46,0,159,0
08,106,00518,0,4,312,174,107,39,52,31,0,61,15,343,361109,76,91,31,281,4
08,106,00519,0,1,30,91,45,16,10,3,0,40,4,35,163904,44,26,3,136,1
08,107,00520,0,1,80,312,70,87,13,7,0,75,8,90,251131,83,100,7,382,1
08,107,00521,0,0,0,252,0,71,0,0,0,85,0,0,150898,85,71,0,252,0
08,107,00522,0,1,100,346,41,114,26,19,0,95,15,118,423859,110,140,19,387,1
08,107,00523,0,2,200,263,161,62,36,24,0,91,7,216,349084,98,98,24,424,2
08,107,00524,0,0,0,85,0,22,0,0,0,27,0,0,74597,27,22,0,85,0
08,107,00525,0,1,60,227,27,56,11,5,0,79,3,65,208519,82,67,5,254,1
08,108,00526,0,2,105,272,106,82,29,12,0,71,12,121,346551,83,111,12,378,2
08,108,00527,0,0,0,237,0,58,0,0,0,63,0,0,171558,63,58,0,237,0
08,108,00528,0,0,0,107,0,31,0,0,0,33,0,0,105635,33,31,0,107,0
08,108,00529,0,1,60,92,31,23,11,5,0,36,4,65,142741,40,34,5,123,1
08,108,00530,1,0,0,116,0,31,0,0,4,42,0,0,97500,42,31,4,116,1
08,108,00531,0,2,201,233,173,65,46,34,0,81,14,237,334871,95,111,34,406,2
08,108,00532,0,0,0,124,0,34,0,0,0,39,0,0,136346,39,34,0,124,0
08,109,00533,0,2,70,236,56,66,20,10,0,82,7,85,338852,89,86,10,292,2
08,109,00534,0,2,132,219,52,72,23,10,0,63,7,142,264592,70,95,10,271,2
08,109,00535,0,0,0,243,0,74,0,0,0,71,0,0,260471,71,74,0,243,0
08,109,00536,0,3,155,291,110,80,43,27,0,100,17,176,420842,117,123,27,401,3
08,109,00537,0,2,50,240,38,69,16,6,0,74,5,65,349033,79,85,6,278,2
08,110,00538,0,3,250,487,88,174,56,44,0,127,6,270,413256,133,230,44,575,3
08,110,00539,0,3,45,185,39,45,15,3,0,51,7,65,166050,58,60,3,224,3
08,110,00540,0,7,410,315,129,104,59,27,0,95,20,450,272632,115,163,27,444,7
08,110,00541,0,3,459,413,96,144,31,11,0,105,15,484,395009,120,175,11,509,3
08,110,00542,0,7,223,388,159,117,61,23,0,123,27,278,444052,150,178,23,547,7
08,110,00543,0,0,0,244,0,73,0,0,0,75,0,0,213016,75,73,0,244,0
08,110,00544,0,0,0,182,0,53,0,0,0,65,0,0,191082,65,53,0,182,0
08,110,00545,0,2,50,167,36,48,15,5,0,48,5,65,206015,53,63,5,203,2
08,110,00546,0,1,5,141,20,52,7,1,0,42,3,10,139506,45,59,1,161,1
08,110,00547,1,0,0,285,4,105,2,0,4,89,2,0,328692,91,107,4,289,1
08,110,00548,0,1,55,375,35,102,11,5,0,115,3,60,303200,118,113,5,410,1
08,110,00549,0,3,71,165,106,41,28,10,0,57,13,86,283536,70,69,10,271,3
08,110,00550,0,1,88,126,58,28,33,26,0,50,4,98,223240,54,61,26,184,1
08,111,00551,0,11,466,217,200,44,112,54,0,83,37,527,305623,120,156,54,417,11
08,111,00552,0,8,55,323,72,79,32,2,0,104,20,105,320956,124,111,2,395,8
08,111,00553,0,3,369,616,260,173,74,52,0,207,23,505,644186,230,247,52,876,3
08,111,00554,0,8,139,623,122,147,48,9,0,198,22,184,423208,220,195,9,745,8
08,111,00555,2,12,263,703,229,207,102,28,8,223,35,363,583224,258,309,36,932,14
08,111,00556,1,2,135,552,103,153,30,17,4,176,14,150,399844,190,183,21,655,3
08,112,00557,0,4,150,347,52,93,28,10,0,102,13,180,252882,115,121,10,399,4
08,112,00558,1,2,105,459,41,134,25,13,4,145,6,125,396998,151,159,17,500,3
08,112,00559,0,0,0,376,0,102,0,0,0,119,0,0,268992,119,102,0,376,0
08,112,00560,1,7,260,442,245,118,76,35,4,142,37,336,524802,179,194,39,687,8
08,112,00561,0,0,0,243,0,76,0,0,0,77,0,0,192924,77,76,0,243,0
08,112,00562,0,8,195,425,116,114,46,12,0,152,27,240,388669,179,160,12,541,8
08,112,00563,1,2,36,395,58,91,19,7,4,134,6,46,306097,140,110,11,453,3
08,112,00564,0,1,50,380,27,92,11,5,0,122,8,60,224020,130,103,5,407,1
08,112,00565,0,10,330,259,137,61,56,13,0,93,38,390,345527,131,117,13,396,10
08,112,00566,0,5,130,457,86,107,37,14,0,144,23,155,404869,167,144,14,543,5
08,113,00567,0,2,75,582,63,115,18,8,0,251,7,90,564500,258,133,8,645,2
08,113,00568,0,0,0,648,0,160,0,0,0,235,0,0,465257,235,160,0,648,0
08,113,00569,0,0,0,535,0,133,0,0,0,171,0,0,320952,171,133,0,535,0
08,113,00570,0,15,2126,295,1566,86,394,295,0,110,108,2229,1378224,218,480,295,1861,15
08,113,00571,0,0,0,587,0,85,0,0,0,258,0,0,452134,258,85,0,587,0
08,113,00572,0,0,0,379,0,93,0,0,0,159,0,0,221897,159,93,0,379,0
08,113,00573,1,2,156,330,82,90,28,14,4,119,12,176,284059,131,118,18,412,3
08,114,00574,0,2,200,245,147,35,44,29,0,125,12,236,263879,137,79,29,392,2
08,114,00575,0,2,50,383,46,55,18,7,0,179,9,65,303611,188,73,7,429,2
08,114,00576,0,0,0,139,0,19,0,0,0,64,0,0,100981,64,19,0,139,0
08,115,00577,0,0,0,235,0,42,0,0,0,112,0,0,237080,112,42,0,235,0
08,115,00578,0,0,0,211,0,15,0,0,0,102,0,0,253350,102,15,0,211,0
08,115,00579,0,3,150,442,61,88,32,17,0,171,10,175,422647,181,120,17,503,3
08,115,00580,0,0,0,329,0,94,0,0,0,131,0,0,272550,131,94,0,329,0
08,115,00581,0,1,30,487,31,50,7,2,0,256,4,35,453869,260,57,2,518,1
08,115,00582,0,1,200,307,171,31,38,25,0,151,15,226,370672,166,69,25,478,1
08,115,00583,0,0,0,106,0,7,0,0,0,52,0,0,107981,52,7,0,106,0
08,115,00584,0,0,0,556,0,104,0,0,0,229,0,0,485344,229,104,0,556,0
08,116,00585,0,0,0,238,0,76,0,0,0,69,0,0,176682,69,76,0,238,0
08,116,00586,0,1,80,342,24,96,10,4,0,134,4,90,239642,138,106,4,366,1
08,116,00587,0,3,156,334,107,95,29,14,0,102,8,202,264423,110,124,14,441,3
08,116,00588,0,3,175,434,153,121,29,6,0,120,11,283,302553,131,150,6,587,3
08,116,00589,0,0,0,202,0,69,0,0,0,70,0,0,151141,70,69,0,202,0
08,116,00590,0,1,120,551,33,133,9,2,0,187,7,130,487420,194,142,2,584,1
08,116,00591,0,0,0,265,0,76,0,0,0,79,0,0,206831,79,76,0,265,0
08,117,00592,0,3,60,237,56,61,21,6,0,65,10,80,142185,75,82,6,293,3
08,117,00593,0,4,185,262,130,57,41,16,0,79,15,236,186040,94,98,16,392,4
08,117,00594,0,2,38,270,67,89,20,5,0,91,9,64,261632,100,109,5,337,2
08,117,00595,0,6,104,150,103,41,44,13,0,46,25,154,224389,71,85,13,253,6
08,117,00596,0,1,36,298,34,90,9,3,0,88,3,41,221806,91,99,3,332,1
08,118,00597,0,2,50,333,46,85,19,9,0,110,7,66,226718,117,104,9,379,2
08,118,00598,1,0,0,278,0,79,0,0,4,92,0,0,205248,92,79,4,278,1
08,118,00599,0,4,210,278,121,49,43,21,0,98,10,266,220811,108,92,21,399,4
08,118,00600,0,0,0,184,0,35,0,0,0,55,0,0,120963,55,35,0,184,0
08,118,00601,0,2,310,226,227,47,55,30,0,82,19,346,368327,101,102,30,453,2
08,118,00602,0,1,36,342,25,73,7,2,0,111,3,41,198978,114,80,2,367,1
08,118,00603,1,4,90,274,65,58,27,8,4,103,18,122,234337,121,85,12,339,5
08,118,00604,0,4,115,273,97,68,33,8,0,81,22,147,198125,103,101,8,370,4
08,118,00605,1,8,264,369,108,98,59,26,6,116,20,331,263900,136,157,32,477,9
08,119,00606,1,7,162,340,125,103,55,26,4,109,18,213,418180,127,158,30,465,8
08,119,00607,0,9,1503,271,884,100,286,224,0,79,57,1677,798454,136,386,224,1155,9
08,119,00608,0,0,0,201,0,54,0,0,0,50,0,0,127803,50,54,0,201,0
08,119,00609,0,3,318,154,176,22,46,30,0,72,14,352,342851,86,68,30,330,3
08,119,00610,0,2,50,208,58,57,22,10,0,72,9,65,224181,81,79,10,266,2
08,119,00611,0,3,408,188,92,57,30,16,0,53,8,428,187459,61,87,16,280,3
08,119,00612,0,0,0,192,0,44,0,0,0,55,0,0,126466,55,44,0,192,0
08,119,00613,0,2,40,125,33,37,13,3,0,43,8,55,154716,51,50,3,158,2
08,119,00614,1,5,100,239,103,64,35,16,4,72,9,130,202758,81,99,20,342,6
08,120,00615,0,1,75,277,37,71,13,7,0,77,4,85,240872,81,84,7,314,1
08,120,00616,0,0,0,211,0,45,0,0,0,66,0,0,117618,66,45,0,211,0
08,120,00617,1,2,111,232,104,59,24,12,4,81,11,126,245678,92,83,16,336,3
08,120,00618,0,2,201,192,157,34,42,27,0,69,15,222,286764,84,76,27,349,2
08,120,00619,0,1,30,154,33,26,10,3,0,58,6,40,146736,64,36,3,187,1
08,120,00620,2,1,50,324,33,84,17,10,8,96,4,60,214367,100,101,18,357,3
08,120,00621,0,2,39,110,46,26,15,3,0,45,8,54,168774,53,41,3,156,2
08,121,00622,0,0,0,276,0,65,0,0,0,80,0,0,219968,80,65,0,276,0
08,121,00623,0,2,80,223,31,53,16,4,0,73,8,95,196027,81,69,4,254,2
08,121,00624,0,5,82,86,86,15,34,10,0,32,14,122,127688,46,49,10,172,5
08,121,00625,0,4,62,109,92,22,26,5,0,41,22,92,153973,63,48,5,201,4
08,121,00626,0,3,375,338,223,85,69,39,0,101,15,421,411499,116,154,39,561,3
08,122,00627,0,1,50,287,35,81,11,5,0,99,6,60,254064,105,92,5,322,1
08,122,00628,0,4,50,153,60,37,23,7,0,55,11,75,138549,66,60,7,213,4
08,122,00629,0,1,50,211,87,48,14,6,0,81,4,65,206943,85,62,6,298,1
08,122,00630,1,0,0,185,0,53,0,0,4,64,0,0,123683,64,53,4,185,1
08,122,00631,1,0,0,287,0,66,0,0,4,97,0,0,235535,97,66,4,287,1
08,122,00632,0,0,0,127,0,32,0,0,0,46,0,0,97869,46,32,0,127,0
08,122,00633,0,4,75,168,48,35,19,4,0,56,9,110,134997,65,54,4,216,4
08,122,00634,0,9,526,254,443,67,101,54,0,78,40,597,557759,118,168,54,697,9
08,122,00635,0,0,0,235,0,44,0,0,0,68,0,0,174701,68,44,0,235,0
08,122,00636,0,2,11,247,64,57,13,4,0,85,6,26,217719,91,70,4,311,2
08,122,00637,0,2,65,212,41,53,12,3,0,77,7,80,176620,84,65,3,253,2
08,122,00638,0,1,60,75,42,17,9,3,0,34,3,65,89298,37,26,3,117,1
08,123,00639,0,1,125,148,29,26,16,8,0,57,3,130,171023,60,42,8,177,1
08,123,00640,0,2,50,87,29,8,13,4,0,36,6,65,110723,42,21,4,116,2
08,123,00641,0,2,56,95,57,8,21,8,0,42,8,71,118949,50,29,8,152,2
08,123,00642,0,0,0,207,0,33,0,0,0,74,0,0,144231,74,33,0,207,0
08,123,00643,0,3,143,145,141,32,39,19,0,60,18,169,235119,78,71,19,286,3
08,123,00644,0,0,0,196,0,45,0,0,0,65,0,0,131800,65,45,0,196,0
08,123,00645,0,3,260,239,133,54,60,44,0,91,9,280,244467,100,114,44,372,3
08,124,00646,0,2,300,618,159,143,56,44,0,217,12,316,495384,229,199,44,777,2
08,124,00647,0,0,0,357,0,71,0,0,0,138,0,0,224243,138,71,0,357,0
08,124,00648,1,5,126,534,113,108,34,12,4,205,14,156,343232,219,142,16,647,6
08,124,00649,1,1,100,413,30,82,17,9,4,146,3,105,325652,149,99,13,443,2
08,125,00650,0,0,0,323,0,68,0,0,0,117,0,0,286955,117,68,0,323,0
08,125,00651,1,2,115,468,69,88,19,6,4,169,6,133,298732,175,107,10,537,3
08,125,00652,0,2,384,426,112,88,44,28,0,153,13,420,458471,166,132,28,538,2
08,125,00653,0,0,0,383,0,77,0,0,0,147,0,0,373825,147,77,0,383,0
08,125,00654,0,2,60,313,60,54,13,3,0,126,8,78,379127,134,67,3,373,2
08,126,00655,0,0,0,119,0,26,0,0,0,48,0,0,88608,48,26,0,119,0
08,126,00656,1,0,0,116,0,30,0,0,4,42,0,0,103783,42,30,4,116,1
08,126,00657,0,2,120,177,37,27,13,3,0,70,10,135,134930,80,40,3,214,2
08,126,00658,0,3,128,111,66,19,23,5,0,46,7,148,139965,53,42,5,177,3
08,126,00659,0,5,345,198,201,41,68,42,0,69,23,471,312208,92,109,42,399,5
08,126,00660,0,2,70,213,39,44,16,4,0,70,6,85,199241,76,60,4,252,2
08,126,00661,0,0,0,116,0,22,0,0,0,45,0,0,104607,45,22,0,116,0
08,126,00662,1,0,0,132,0,36,0,0,4,46,0,0,123858,46,36,4,132,1
08,126,00663,0,3,100,197,39,45,21,8,0,71,10,120,219635,81,66,8,236,3
08,126,00664,0,3,50,108,46,25,15,3,0,38,8,70,116107,46,40,3,154,3
08,127,00665,0,0,0,122,0,43,0,0,0,44,0,0,179743,44,43,0,122,0
08,127,00666,0,0,0,190,0,53,0,0,0,60,0,0,168692,60,53,0,190,0
08,127,00667,0,9,856,165,859,38,256,175,0,45,83,1085,1143750,128,294,175,1024,9
08,127,00668,0,8,176,117,238,26,77,26,0,43,29,221,272392,72,103,26,355,8
08,127,00669,0,1,30,152,26,29,13,6,0,58,6,40,186076,64,42,6,178,1
08,128,00670,0,1,30,111,30,35,12,5,0,27,6,40,106899,33,47,5,141,1
08,128,00671,0,2,30,116,50,28,17,7,0,35,15,45,120038,50,45,7,166,2
08,128,00672,0,4,300,97,144,32,47,28,0,30,18,326,213506,48,79,28,241,4
08,128,00673,0,2,110,99,62,17,20,5,0,40,8,120,149934,48,37,5,161,2
08,128,00674,0,0,0,164,0,34,0,0,0,61,0,0,166774,61,34,0,164,0
08,128,00675,0,0,0,170,0,50,0,0,0,57,0,0,141766,57,50,0,170,0
08,128,00676,0,1,50,88,46,2,26,10,0,40,5,60,152411,45,28,10,134,1
08,128,00677,0,1,60,105,32,18,10,4,0,42,4,65,170816,46,28,4,137,1
08,129,00678,0,1,60,152,21,31,10,4,0,59,4,65,173096,63,41,4,173,1
08,129,00679,0,5,622,229,352,39,197,161,0,84,26,695,356613,110,236,161,581,5
08,129,00680,0,1,200,156,23,22,9,2,0,54,5,211,178394,59,31,2,179,1
08,129,00681,0,7,60,60,79,2,27,3,0,28,9,95,142968,37,29,3,139,7
08,129,00682,0,4,102,104,71,22,26,9,0,44,11,128,179418,55,48,9,175,4
08,129,00683,0,1,65,193,40,38,11,3,0,64,6,77,212493,70,49,3,233,1
08,129,00684,0,1,30,119,22,19,7,2,0,46,3,35,167465,49,26,2,141,1
08,130,00685,0,2,90,257,77,53,19,5,0,103,9,114,253344,112,72,5,334,2
08,130,00686,1,0,0,211,11,34,3,0,4,80,2,0,214942,82,37,4,222,1
08,130,00687,0,0,0,192,0,43,0,0,0,76,0,0,230340,76,43,0,192,0
08,130,00688,1,0,0,294,0,55,0,0,4,114,0,0,249149,114,55,4,294,1
08,130,00689,0,9,1639,560,267,126,92,35,0,210,42,1735,898130,252,218,35,827,9
08,130,00690,0,3,115,232,69,49,24,9,0,91,11,142,271487,102,73,9,301,3
08,130,00691,0,0,0,98,0,18,0,0,0,36,0,0,91149,36,18,0,98,0
08,130,00692,0,2,100,250,52,35,19,9,0,108,6,116,248278,114,54,9,302,2
08,130,00693,1,2,80,278,61,55,25,8,4,111,6,90,231204,117,80,12,339,3
08,130,00694,0,2,65,192,37,36,16,5,0,78,7,75,172914,85,52,5,229,2
08,130,00695,0,2,80,183,38,23,12,3,0,88,4,90,206777,92,35,3,221,2
08,131,00696,0,2,65,162,25,51,13,2,0,57,4,75,189775,61,64,2,187,2
08,131,00697,1,0,0,151,0,28,0,0,4,56,0,0,153956,56,28,4,151,1
08,131,00698,0,1,60,87,50,20,12,4,0,34,7,71,133955,41,32,4,137,1
08,131,00699,0,3,176,180,142,26,31,17,0,74,9,198,248560,83,57,17,322,3
08,131,00700,0,0,0,150,0,28,0,0,0,50,0,0,140926,50,28,0,150,0
09,132,00701,0,1,10,48,2,25,8,5,0,9,3,19,519343,12,33,5,50,1
09,132,00702,1,11,376,134,228,62,49,35,4,21,49,479,1369591,70,111,39,362,12
09,132,00703,1,9,184,102,155,45,59,19,1,19,40,330,698667,59,104,20,257,10
09,132,00704,0,2,39,70,38,34,17,10,0,10,25,49,514265,35,51,10,108,2
09,132,00705,0,3,65,67,66,35,35,10,0,10,10,173,363816,20,70,10,133,3
09,133,00706,1,5,70,122.5,89,60,19,11,1,40,1233,111,586247,1273,79,12,211.5,6
09,133,00707,4,3,45,173,199,91,106,11,23,139,62,871,687276,201,197,34,372,7
09,133,00708,2,10,175,338,131,145,57,28,2,132,186,314,1406768,318,202,30,469,12
09,133,00709,1,4,29,79,56,39,11,2,1,17,34,69,532496,51,50,3,135,5
09,133,00710,3,1,20,110,27,42,10,3,5,20,14,35,433868,34,52,8,137,4
09,133,00711,5,1,20,119,44,57,14,3,15,27,8,47,496456,35,71,18,163,6
09,134,00712,5,6,69,118,82,60,17,12,6,56,216,79,721161,272,77,18,200,11
09,134,00713,1,9,154,51,48,26,84,29,3,16,325,484,627932,341,110,32,99,10
09,134,00714,0,5,36,63,20,15,8,4,0,10,31,47,501861,41,23,4,83,5
09,134,00715,3,5,70,98,89,40,69,15,5,26,50,242,1123229,76,109,20,187,8
09,134,00716,1,0,0,103,9,46,8,0,1,75,64,10,705991,139,54,1,112,1
09,135,00717,2,1,30,80,165,41,15,8,2,59,10,90,504467,69,56,10,245,3
09,135,00718,1,2,30,51,9,28,37,28,1,27,3,82,301371,30,65,29,60,3
09,135,00719,1,9,554,164,299,84,224,44,2,65,340,1745,1646464,405,308,46,463,10
09,135,00720,0,2,36,136,16,70,19,6,0,76,70,69,673729,146,89,6,152,2
09,135,00721,1,1,20,113,75,59,18,4,1,45,15,98,993218,60,77,5,188,2
09,135,00722,1,4,60,178,91,88,25,12,1,340,25,223,652095,365,113,13,269,5
09,136,00723,2,1,4,177,1,90,11,4,4,44,10,14,343128,54,101,8,178,3
09,136,00724,1,1,30,159,38,79,11,5,2,10,6,61,340496,16,90,7,197,2
09,136,00725,0,1,10,122,36,60,7,2,0,11,8,50,288962,19,67,2,158,1
09,136,00726,0,6,130,219,147,125,26,19,0,9,10,219,670879,19,151,19,366,6
09,136,00727,0,2,30,182,10,91,10,5,0,31,17,60,355032,48,101,5,192,2
09,136,00728,0,1,30,204,27,106,8,4,0,15,2,51,336679,17,114,4,231,1
09,137,00729,1,2,60,78,53,45,34,14,1,22,30,120,467924,52,79,15,131,3
09,137,00730,2,4,60,87,143,53,105,55,2,33,491,407,775961,524,158,57,230,6
09,137,00731,2,2,24,77,34,57,13,3,3,21,9,116,595809,30,70,6,111,4
09,138,00732,3,2,30,145,42,66,34,6,5,70,17,113,569090,87,100,11,187,5
09,138,00733,9,5,70,259,211,152,90,17,16,177,281,250,772241,458,242,33,470,14
09,138,00734,4,6,374,240,417,124,165,7,6,118,78,639,2102141,196,289,13,657,10
09,139,00735,1,2,60,116,79,71,50.125,17.375,1,1301,41,100,713026,1342,121.125,18.375,195,3
09,139,00736,3,10,144,141,119,79,85,73,9,967,16,167,404904,983,164,82,260,13
09,139,00737,2,2,4,58,102,33,36,3,4,377,7,68,184981,384,69,7,160,4
09,140,00738,3,3,113,147,128,69,82,28,3,50,59,286,637484,109,151,31,275,6
09,140,00739,0,7,391.1923084259033,81,801,40,199.615385055542,62.23076915740967,0,21,199,874.9230766296387,2705849,220,239.61539,62.23077,882,7
09,140,00740,3,3,55,258,92,128,40,20,7,84,53,97,953413,137,168,27,350,6
09,140,00741,2,1,40,161,82,78,45,4,2,113,362,145,384803,475,123,6,243,3
09,141,00742,3,1,100,165,166,80,54,10,3,92,165,311,1110040,257,134,13,331,4
09,141,00743,0,2,33.84615421295166,38,16,21,22.23076915740967,4.384615421295166,0,23,18,99.53845977783203,316391,41,43.23077,4.3846154,54,2
09,141,00744,2,3,88,58,68,32,25,5,2,32,19,129,221188,51,57,7,126,5
09,142,00745,2,2,55,46,48,39,13,10,3,23,20,93,385098,43,52,13,94,4
09,142,00746,0,2,197,100,185,88,26,4,0,24,40,290,867915,64,114,4,285,2
09,142,00747,2,2,6,87,26,79,17,1,3,29,78,85,510161,107,96,4,113,4
09,142,00748,1,2,60,43,65,28,33,9,4,10,65,186,348251,75,61,13,108,3
09,142,00749,0,1,30,60,12,41,23,5,0,14,10,97,433387,24,64,5,72,1
09,142,00750,0,1,30,74,62,56,14,4,0,37,11,70,435158,48,70,4,136,1
09,142,00751,3,1,70,91,82,68,26,10,6,62,101,155,519063,163,94,16,173,4
09,143,00752,0,1,20,75,36,41,18,6,0,33,9,63,427214,42,59,6,111,1
09,143,00753,0,1,30,52,4,38,5,5,0,18,1,30,308797,19,43,5,56,1
09,143,00754,5,2,14,121,25,66,20,5,6,70,28,168,737685,98,86,11,146,7
09,143,00755,0,7,552,119,309,72,207,36,0,24,152,1934,1810181,176,279,36,428,7
09,143,00756,1,1,30,45,17,32,20,4,1,32,6,63,389913,38,52,5,62,2
09,144,00757,3,1,30,61,3,67,6,6,14,56,2,30,224276,58,73,20,64,4
09,144,00758,2,2,34,44,25,38,21,7,3,21,11,81,404567,32,59,10,69,4
09,144,00759,0,3,110,70,108,52,47,20,0,8,28,261,551440,36,99,20,178,3
09,144,00760,0,2,60,69,89,41,19,6,0,14,19,94,384280,33,60,6,158,2
09,145,00761,6,4,44,150,171,80,103,13,6,118,49,350,568975,167,183,19,321,10
09,145,00762,2,1,5,154,2,60,2,1,2,59,1,6,439013,60,62,3,156,3
09,145,00763,1,0,0,33,7,21,7,0,1,44,32,36,351620,76,28,1,40,1
09,145,00764,1,5,185,70,549,50,791,48,6,62,94,925,1187196,156,841,54,619,6
09,146,00765,3,2,34,36,36,46,5,3,8,48,6,41,367441,54,51,11,72,5
09,146,00766,4,102,1639,69,3654,85,1086,151,1,120,236,12445,2186655,356,1171,152,3723,106
09,146,00767,0,4,39,39,72,23,28,7,0,38,23,89,506777,61,51,7,111,4
09,146,00768,3,2,34,119,25,56,22,7,3,35,79,74,466808,114,78,10,144,5
09,146,00769,1,0,0,46,73,35,11,0,0,20,11,43,460555,31,46,0,119,1
09,146,00770,6,0,0,75,72,44,12,0,0,38,2,54,430487,40,56,0,147,6
09,147,00771,1,3,135,84,92,41,18,4,1,18,10,147,361489,28,59,5,176,4
09,147,00772,1,1,154,120,121,56,41,22,2,32,11,224,956053,43,97,24,241,2
09,147,00773,2,2,35,217,17,97,6,6,3,109,39,35,505925,148,103,9,234,4
09,147,00774,0,6,130,109,85,56,14,11,0,21,28,170,674634,49,70,11,194,6
09,148,00775,2,4,330,93,401,40,65,43,2,43,32,397,724450,75,105,45,494,6
09,148,00776,8,1,10,147,10,75,5,3,8,50,16,17,331718,66,80,11,157,9
09,148,00777,3,3,65,159,36,78,19,9,3,67,25,117,812225,92,97,12,195,6
09,149,00778,1,2,34,10,54,5,7,3,0,4,8,48,554259,12,12,3,64,3
09,149,00779,6,6,74,119,55,58,27,11,0,78,24,114,642762,102,85,11,174,12
09,149,00780,0,2,40,34,19,18,9,5,0,62,13,97,404198,75,27,5,53,2
09,149,00781,0,1,30,18,53,10,10,5,0,5,11,53,389812,16,20,5,71,1
09,149,00782,2,5,353,111,358,74,127,41,4,36,92,467,1002821,128,201,45,469,7
09,149,00783,0,3,70,76,139,38,38,19,0,14,427,168,687829,441,76,19,215,3
09,150,00784,1,4,45,71,83,33,40,5,1,17,15,186,674423,32,73,6,154,5
09,150,00785,1,3,32,124,53,64,41,5,1,47,11,80,491221,58,105,6,177,4
09,150,00786,0,4,52,102,36,46,6,5,0,18,8,57,704949,26,52,5,138,4
09,150,00787,0,11,730,90,591,43,193,62,0,22,150,1319,1628221,172,236,62,681,11
09,150,00788,3,1,30,102,45,54,17,5,3,31,13,85,476756,44,71,8,147,4
09,150,00789,0,2,45,57,6,28,10,6,0,16,17,47,472062,33,38,6,63,2
09,151,00790,2,4,235,180,91,107,117,32,2,68,59,527,794512,127,224,34,271,6
09,151,00791,2,1,20,79,38,46,46,15,2,19,37,44,636596,56,92,17,117,3
09,151,00792,1,2,30,65,21,38,10,5,1,18,18,45,598213,36,48,6,86,3
09,152,00793,0,1,30,149,70,80,10,5,0,19,10,45,673104,29,90,5,219,1
09,152,00794,0,2,34,153,98,88,18,7,0,20,8,56,736336,28,106,7,251,2
09,152,00795,2,3,391,106,363,73,108,51,4,21,13,731,998773,34,181,55,469,5
09,152,00796,0,1,30,103,15,61,5,4,0,39,1,31,596616,40,66,4,118,1
09,153,00797,3,1,4,90,6,40,2,1,3,33,8,4,416789,41,42,4,96,4
09,153,00798,0,0,0,114,0,60,8,0,0,57,18,22,336408,75,68,0,114,0
09,153,00799,0,3,46,93,60,55,18,9,0,26,25,64,702585,51,73,9,153,3
09,153,00800,0,3,32,130,48,76,17,8,0,29,18,72,816987,47,93,8,178,3
09,153,00801,0,3,46,160,67,134,18,8,0,59,7,103,1159895,66,152,8,227,3
09,153,00802,0,0,0,50,0,23,0,0,0,9,2,0,587953,11,23,0,50,0
09,154,00803,6,2,34,205,58,103,18,8,9,41,11,82,926021,52,121,17,263,8
09,154,00804,1,4,80,66,375,39,68,46,1,21,33,128,889474,54,107,47,441,5
09,154,00805,3,2,60,124,83,56,12,4,4,25,8,79,753412,33,68,8,207,5
09,154,00806,0,1,30,111,13,49,9,6,0,16,2,36,750529,18,58,6,124,1
09,154,00807,9,2,3,247,53,131,13,8,9,75,13,22,595244,88,144,17,300,11
09,154,00808,6,1,25,167,67,80,13,10,9,55,6,40,569117,61,93,19,234,7
09,155,00809,3,2,34,44,98,30,17,13,3,74,19,44,761208,93,47,16,142,5
09,155,00810,2,1,4,53,13,24,3,1,1,29,4,11,483631,33,27,2,66,3
09,155,00811,7,4,312,82,225,88,53,21,11,72,9,413,1199087,81,141,32,307,11
09,155,00812,3,6,69,25,153,27,27,15,4,25,8,133,665751,33,54,19,178,9
09,155,00813,26,3,30,144,29,213,14,8,33,183,10,53,983082,193,227,41,173,29
09,156,00814,1,6,76,61,125,45,46,21,2,23,9,156,711571,32,91,23,186,7
09,156,00815,7,2,31,102,136,86,19,8,6,52,18,71,719959,70,105,14,238,9
09,156,00816,1,3,154,41,189,43,63,41,1,15,55,208,876910,70,106,42,230,4
09,156,00817,2,0,0,58,27,29,18,0,2,26,6,19,459442,32,47,2,85,2
09,156,00818,1,1,15,43,56,21,13,1,1,10,7,55,340029,17,34,2,99,2
09,157,00819,0,1,30,21,16,40,8,6,0,24,5,32,368453,29,48,6,37,1
09,157,00820,10,3,63,103,33,185,16,4,16,56,14,74,349654,70,201,20,136,13
09,157,00821,2,65,2320,18,1405,42,800,132,2,57,3981,6892,3391167,4038,842,134,1423,67
09,157,00822,1,1,5,33,10,49,2,2,1,22,12,5,480495,34,51,3,43,2
09,158,00823,8,1,20,50,111,71,28,2,21,32,9,105,433664,41,99,23,161,9
09,158,00824,10,2,15,27,23,74,15,4,15,25,5,44,502011,30,89,19,50,12
09,158,00825,0,1,166,29,312,22,126,28,0,11,58,627,831074,69,148,28,341,1
09,158,00826,3,1,30,91,61,39,8,6,4,27,2,50,521118,29,47,10,152,4
09,158,00827,2,0,0,51,76,48,5,0,1,107,1,30,292721,108,53,1,127,2
09,158,00828,0,0,0,17,55,24,7,0,0,11,9,38,324875,20,31,0,72,0
09,158,00829,0,1,10,70,9,69,3,1,0,16,2,15,499802,18,72,1,79,1
09,159,00830,3,2,34,39,49,25,18,7,4,29,20,74,666006,49,43,11,88,5
09,159,00831,18,0,0,206,0,130,0,0,18,109,0,0,186140,109,130,18,206,18
09,159,00832,1,6,370,64,144,37,125,106,1,61,65,436,1032970,126,162,107,208,7
09,160,00833,1,6,114,45,199,35,50,17,1,62,55,278,768699,117,85,18,244,7
09,160,00834,0,1,30,23,20,15,9,5,0,15,7,40,454463,22,24,5,43,1
09,160,00835,0,1,30,9,28,9,7,7,0,8,8,30,433405,16,16,7,37,1
09,161,00836,2,1,30,4,0,7,8,8,1,23,9,30,214678,32,15,9,4,3
09,161,00837,2,0,0,53,0,15,0,0,3,21,0,0,95063,21,15,3,53,2
09,161,00838,4,2,120,37,0,50,34,26,5,23,31,199,591143,54,84,31,37,6
09,161,00839,1,2,8,31,24,51,14,2,2,24,12,48,534090,36,65,4,55,3
09,161,00840,0,0,0,33,0,12,0,0,0,12,0,0,146802,12,12,0,33,0
09,162,00841,22,2,36,83,65,596,17,2,56,190,5,70,678733,195,613,58,148,24
09,162,00842,1,6,94,44,146,53,39,23,0,44,59,137,700609,103,92,23,190,7
09,163,00843,2,1,30,24,27,39,0,0,0,19,1,30,322427,20,39,0,51,3
09,163,00844,1,1,50,17,54,22,4,3,0,35,8,60,280186,43,26,3,71,2
09,163,00845,5,1,1,91,12,52,13,2,1,54,34,30,532500,88,65,3,103,6
09,163,00846,0,0,5,13,34,22,18,1,0,32,5,71,382210,37,40,1,47,0
09,163,00847,7,1,30,33,19,64,7,0,4,69,7,48,278753,76,71,4,52,8
09,164,00848,3,2,37,157,45,88,8,2,4,72,12,55,530025,84,96,6,202,5
09,164,00849,3,35,4815,179,1949,115,336,239,5,32,91,5152,3470271,123,451,244,2128,38
09,164,00850,2,30,30,139,6,101,7,7,1,45,37,30,580859,82,108,8,145,32
09,165,00851,5,2,8,32,39,50,12,5,1,68,4,26,338311,72,62,6,71,7
09,165,00852,1,1,30,83,28,89,7,4,1,26,5,42,283668,31,96,5,111,2
09,165,00853,3,2,34,28,69,40,15,7,3,25,3,65,369776,28,55,10,97,5
09,165,00854,19,2,113,160,156,135,28,22,70,95,13,173,396631,108,163,92,316,21
09,165,00855,0,2,60,7,92,6,11,8,0,5,4,73,301122,9,17,8,99,2
09,166,00856,2,2,13,78,25,163,5,2,2,69,8,16,307825,77,168,4,103,4
09,166,00857,3,2,35,33,34,75,15,6,4,41,14,58,233576,55,90,10,67,5
09,166,00858,0,0,0,0,5,0,2,0,0,2,1,14,177711,3,2,0,5,0
09,166,00859,0,3,35,0,111,0,9,1,0,7,12,80,393993,19,9,1,111,3
09,166,00860,5,13,761,33,982,30,329,81,0,56,149,1416,885145,205,359,81,1015,18
09,167,00861,11,2,34,127,20,116,11,7,16,81,22,44,308784,103,127,23,147,13
09,167,00862,1,1,200,38,157,55,36,9,1,51,32,299,502908,83,91,10,195,2
09,167,00863,1,2,50,19,22,24,20,6,0,14,5,104,409498,19,44,6,41,3
09,168,00864,8,4,132,72,107,150,17,3,19,53,208,207,364438,261,167,22,179,12
09,168,00865,1,1,20,16,15,48,7,7,1,24,1,20,218967,25,55,8,31,2
09,168,00866,6,1,10,48,7,68,10,4,3,38,127,29,169664,165,78,7,55,7
09,168,00867,0,1,30,20,51,20,12,3,0,16,9,79,351064,25,32,3,71,1
09,169,00868,3,1,5,15,6,27,2,2,1,51,7,9,336927,58,29,3,21,4
09,169,00869,0,2,34,2,37,5,10,7,0,6,16,46,155356,22,15,7,39,2
09,169,00870,1,5,140,32,56,38,29,27,1,28,9,143,383566,37,67,28,88,6
09,170,00871,2,56,670,71,169,58,154,125,4,30,390,829,663989,420,212,129,240,58
09,170,00872,2,0,30,54,122,54,9,3,0,36,33,79,478980,69,63,3,176,2
09,170,00873,3,1,12,32,189,22,57,5,2,79,4,177,360803,83,79,7,221,4
09,170,00874,1,1,30,37,14,28,5,5,3,19,16,30,295310,35,33,8,51,2
09,171,00875,5,4,134,228,63,104,45,37,5,45,11,148,709742,56,149,42,291,9
09,171,00876,1,0,0,51,0,37,0,0,5,18,0,0,281623,18,37,5,51,1
09,172,00877,6,4,56,165,49,94,16,11,8,192,8,74,749514,200,110,19,214,10
09,172,00878,4,2,200,134,59,82,29,8,5,95,30,355,1096400,125,111,13,193,6
09,172,00879,5,3,36,126,5,61,13,7,9,40,10,65,786565,50,74,16,131,8
09,173,00880,6,0,0,86,0,84,0,0,12,72,0,0,610473,72,84,12,86,6
09,173,00881,8,2,38,71,32,117,7,3,4,165,19,52,910425,184,124,7,103,10
09,173,00882,2,1,120,19,260,30,62,2,2,56,85,769,640175,141,92,4,279,3
09,173,00883,2,1,30,151,28,218,5,0,2,227,4,66,610374,231,223,2,179,3
09,173,00884,8,0,0,109,0,53,0,0,13,41,0,0,437412,41,53,13,109,8
09,174,00885,1,1,30,23,36,11,17,5,2,21,10,101,514936,31,28,7,59,2
09,174,00886,4,2,105,94,52,64,6,0,8,45,11,110,563415,56,70,8,146,6
09,174,00887,2,2,29,46,109,29,18,4,3,24,11,52,521208,35,47,7,155,4
09,175,00888,0,2,45,64,25,40,16,9,0,51,26,63,823141,77,56,9,89,2
09,175,00889,13,2,34,170,74,127,18,9,13,123,16,62,859118,139,145,22,244,15
09,175,00890,0,5,335,5,292,3,131,73,0,27,24,735,1395744,51,134,73,297,5
09,175,00891,2,3,62,67,35,39,31,9,2,69,11,166,365380,80,70,11,102,5
09,175,00892,1,0,0,49,2,32,5,0,2,17,6,20,606771,23,37,2,51,1
09,175,00893,2,0,0,92,39,63,8,0,7,34,10,60,944233,44,71,7,131,2
09,175,00894,2,0,0,71,13,44,4,0,5,18,2,1,579716,20,48,5,84,2
09,175,00895,0,0,0,18,0,10,0,0,0,8,0,0,378715,8,10,0,18,0
09,176,00896,3,0,0,88,15,63,7,0,4,52,12,36,589575,64,70,4,103,3
09,176,00897,3,1,1,73,55,35,11,5,3,39,3,31,304680,42,46,8,128,4
09,176,00898,11,4,234,57,257,138,69,21,31,96,1934,562,978098,2030,207,52,314,15
09,176,00899,2,1,30,20,10,42,8,5,2,84,4,35,321338,88,50,7,30,3
09,176,00900,0,0,0,11,3,13,1,0,0,11,22,2,445173,33,14,0,14,0
09,176,00901,0,2,36,114,96,34,12,6,0,24,15,50,621461,39,46,6,210,2
09,177,00902,3,1,4,14,7,26,2,0,4,24,25,8,464180,49,28,4,21,4
09,177,00903,5,0,0,147,0,81,0,0,8,78,0,0,479692,78,81,8,147,5
09,177,00904,4,0,0,42,2,69,1,0,5,25,1,0,385740,26,70,5,44,4
09,177,00905,4,5,330,47,348,88,89,59,22,22,34,533,691419,56,177,81,395,9
09,177,00906,0,1,20,66,14,60,5,3,0,47,1,30,449733,48,65,3,80,1
09,178,00907,5,1,13,134,48,102,17,1,32,54,27,71,603929,81,119,33,182,6
09,178,00908,0,0,0,89,0,54,0,0,0,33,0,0,440201,33,54,0,89,0
09,178,00909,2,0,0,82,0,48,6,0,1,26,10,24,546908,36,54,1,82,2
09,178,00910,1,0,1.857142806053162,36,62,43,7.857142448425293,.1428571492433548,2,38,10,54.28571319580078,557630,48,50.857143,2.1428571,98,1
09,178,00911,3,0,0,36,0,27,0,0,5,31,0,0,248593,31,27,5,36,3
09,179,00912,7,1,30,95,9,69,3,1,12,65,7,38,709778,72,72,13,104,8
09,179,00913,0,0,0,46,0,25,0,0,0,18,0,0,390885,18,25,0,46,0
09,179,00914,1,2,39,40,63,18,15,12,1,18,4,49,447330,22,33,13,103,3
09,179,00915,2,2,149,94,228,52,35,20,3,54,32,243,833233,86,87,23,322,4
09,179,00916,3,0,0,81,0,57,0,0,3,29,0,0,420439,29,57,3,81,3
09,179,00917,1,1,8,59,6,32,2,2,3,60,1,8,471355,61,34,5,65,2
09,179,00918,5,1,30,79,34,46,10,0,10,65,7,84,523456,72,56,10,113,6
09,180,00919,0,2,32,33,38,22,11,2,0,35,18,66,1272016,53,33,2,71,2
09,180,00920,1,0,0,11,0,6,0,0,0,17,0,0,546983,17,6,0,11,1
09,180,00921,1,2,232,23,240,27,52,30,4,32,15,367,843877,47,79,34,263,3
09,180,00922,2,1,4,12,21,25,5,3,2,25,1,8,824728,26,30,5,33,3
09,181,00923,2,1,30,137,26,57,7,3,8,26,503,41,681353,529,64,11,163,3
09,181,00924,2,1,5,68,16,35,9,3,2,20,5,16,435872,25,44,5,84,3
09,182,00925,3,2,145,40,119,14,50,20,3,48,86,337,666644,134,64,23,159,5
09,182,00926,3,2,60,13,82,14,23,10,3,20,7,112,779141,27,37,13,95,5
09,182,00927,1,1,30,17,21,25,6,0,0,21,8,49,702770,29,31,0,38,2
09,183,00928,3,3,178,80,194,56,38,24,3,30,24,320,1169970,54,94,27,274,6
09,183,00929,1,1,30,58,35,34,10,4,1,20,5,32,855573,25,44,5,93,2
09,183,00930,0,0,30,51,0,45,6,6,0,15,10,30,761781,25,51,6,51,0
09,183,00931,0,1,24,79,55,46,10,5,0,25,3,38,646376,28,56,5,134,1
09,184,00932,1,0,0,28,4,20,2,0,1,15,7,4,420425,22,22,1,32,1
09,184,00933,0,2,8,13,28,16,10,4,0,14,8,31,610152,22,26,4,41,2
09,184,00934,0,1,4,14,1,15,23,2,0,19,7,16,597637,26,38,2,15,1
09,184,00935,0,1,30,8,31,9,4,4,0,10,9,30,454165,19,13,4,39,1
09,184,00936,0,1,10,8,22,10,9,2,0,15,7,21,475602,22,19,2,30,1
09,185,00937,0,0,0,22,0,10,0,0,0,8,0,0,358187,8,10,0,22,0
09,185,00938,0,2,34,44,57,27,14,7,0,16,7,48,948619,23,41,7,101,2
09,185,00939,0,1,300,84,244,66,26,20,0,24,27,425,948167,51,92,20,328,1
09,185,00940,0,0,0,10,0,2,0,0,0,1,0,0,205805,1,2,0,10,0
09,186,00941,1,1,30,5,67,16,10,8,6,9,1,47,474885,10,26,14,72,2
09,186,00942,7,1,30,25,129,49,11,0,11,23,176,52,721891,199,60,11,154,8
09,186,00943,1,0,0,29,4,13,3,0,1,12,1,4,517169,13,16,1,33,1
09,187,00944,0,2,8,0,11,0,8,0,0,6,4,14,511013,10,8,0,11,2
09,187,00945,1,3,48,26,52,51,14,6,1,10,350,80,539682,360,65,7,78,4
09,187,00946,0,2,4,0,20,0,2,1,0,11,3,29,487187,14,2,1,20,2
09,187,00947,0,2,154,11,202,10,41,25,0,27,24,297,1146614,51,51,25,213,2
09,188,00948,1,0,0,51,4,4,1,0,1,9,5,1,395110,14,5,1,55,1
09,188,00949,3,2,50,4,44,45,35,6,13,13,20,114,393395,33,80,19,48,5
09,188,00950,1,13,160,54,244,74,111,20,1,24,77,667,1629192,101,185,21,298,14
09,188,00951,0,1,30,0,12,0,5,5,0,8,1,30,453321,9,5,5,12,1
09,188,00952,1,1,30,13,79,33,8,5,1,21,1,44,446553,22,41,6,92,2
09,188,00953,2,0,0,61,0,52,0,0,15,19,0,0,583293,19,52,15,61,2
09,188,00954,1,1,30,27,8,28,3,1,1,13,24,61,536968,37,31,2,35,2
09,189,00955,3,2,21,69,28,42,11,1,3,28,9,67,1126287,37,53,4,97,5
09,189,00956,17,2,60,104,106,153,31,10,22,71,14,126,956213,85,184,32,210,19
09,189,00957,4,2,51,70,12,54,18,11,7,18,4,64,614091,22,72,18,82,6
09,189,00958,5,0,0,130,0,81,0,0,11,42,5,0,867364,47,81,11,130,5
09,190,00959,4,3,365,116,198,92,57,49,6,41,5,398,1237226,46,149,55,314,7
09,190,00960,1,1,30,54,32,21,9,8,1,19,8,43,439577,27,30,9,86,2
09,190,00961,1,2,4,50,14,13,5,2,1,11,4,8,369791,15,18,3,64,3
09,190,00962,3,2,38,101,107,135,35,8,23,27,123,159,604085,150,170,31,208,5
09,190,00963,1,1,4,97,65,33,13,2,2,17,7,60,449077,24,46,4,162,2
09,191,00964,0,0,0,31,6,7,5,0,0,11,5,6,458671,16,12,0,37,0
09,191,00965,1,3,27,156,115,68,24,10,1,60,14,67,899740,74,92,11,271,4
09,191,00966,0,5,430,47,719,34,109,3,0,27,21,1332,978019,48,143,3,766,5
09,191,00967,0,0,0,56,10,24,8,0,0,24,5,13,594742,29,32,0,66,0
09,191,00968,2,1,1,53,10,31,2,1,7,20,4,1,696376,24,33,8,63,3
09,191,00969,1,0,0,44,2,18,1,0,0,16,1,2,581025,17,19,0,46,1
09,191,00970,1,0,0,33,33,17,13,0,1,13,7,62,400425,20,30,1,66,1
09,192,00971,1,2,40,24,109,42,27,4,0,15,8,64,467087,23,69,4,133,3
09,192,00972,0,0,0,24,1,15,0,0,0,8,3,1,332898,11,15,0,25,0
09,192,00973,0,5,114,63,91,27,46,33,0,19,57,136,910037,76,73,33,154,5
09,192,00974,1,1,30,29,18,8,9,6,1,10,12,44,493043,22,17,7,47,2
09,193,00975,0,1,30,37,65,10,7,4,0,12,2,41,392120,14,17,4,102,1
09,193,00976,0,0,0,34,0,11,0,0,0,12,0,0,392570,12,11,0,34,0
09,193,00977,0,1,30,52,84,13,15,6,0,21,4,75,547660,25,28,6,136,1
09,193,00978,0,7,315,73,207,18,36,26,0,27,1231,440,978690,1258,54,26,280,7
09,193,00979,0,2,8,39,51,15,20,5,0,13,12,40,539964,25,35,5,90,2
09,193,00980,0,0,0,29,0,18,0,0,0,9,0,0,386745,9,18,0,29,0
09,194,00981,2,2,33,3,39,39,12,8,6,26,13,57,761526,39,51,14,42,4
09,194,00982,0,0,0,1,0,0,0,0,0,8,0,0,455800,8,0,0,1,0
09,194,00983,0,2,24,0,48,18,10,5,0,4,15,35,736192,19,28,5,48,2
09,194,00984,0,1,90,3,20,5,15,1,0,33,20,155,1074197,53,20,1,23,1
09,194,00985,4,1,30,19,43,54,12,3,12,28,21,64,800412,49,66,15,62,5
09,194,00986,2,2,48,9,99,29,23,10,8,13,6,72,663307,19,52,18,108,4
09,195,00987,2,1,4,23,6,23,3,1,3,24,5,4,547109,29,26,4,29,3
09,195,00988,1,2,25,40,185,37,27,5,10,19,37,217,602449,56,64,15,225,3
09,195,00989,0,2,213,27,145,71,47,31,0,72,9,302,839000,81,118,31,172,2
09,195,00990,0,2,35,18,34,26,12,5,0,30,354,58,912936,384,38,5,52,2
09,195,00991,1,0,0,1,17,14,2,0,5,16,23,21,713591,39,16,5,18,1
09,196,00992,3,1,30,7,34,40,8,8,1,25,3,37,691013,28,48,9,41,4
09,196,00993,2,3,145,11,132,11,33,14,2,19,2685,191,834155,2704,44,16,143,5
09,196,00994,1,1,100,2,63,2,1,0,0,15,6,106,425882,21,3,0,65,2
09,197,00995,8,1,4,30,13,68,7,1,7,37,7,24,626772,44,75,8,43,9
09,197,00996,10,12,1351,84,971,72,152,110,8,57,240,1547,3048783,297,224,118,1055,22
09,198,00997,2,2,74,10,22,20,15,12,1,13,23,79,568671,36,35,13,32,4
09,198,00998,0,2,130,0,59,0,40,29,0,5,12,160,567373,17,40,29,59,2
09,198,00999,0,1,5,3,8,0,5,2,0,7,66,12,441206,73,5,2,11,1
09,199,01000,2,11,423,73,520,72,55,12,19,22,36,725,1176682,58,127,31,593,13
09,199,01001,0,0,0,31,0,235,0,0,0,13,0,0,366521,13,235,0,31,0
09,199,01002,1,0,0,18,0,29,0,0,0,11,0,0,240874,11,29,0,18,1
09,199,01003,2,2,34,25,45,25,14,9,2,17,8,53,710944,25,39,11,70,4
09,200,01004,1,0,0,18,9,9,7,0,1,3,4,32,290126,7,16,1,27,1
09,200,01005,2,4,258,117,134,61,67,45,2,33,38,295,900714,71,128,47,251,6
09,200,01006,2,9,653,108,212,56,42,34,2,29,39,695,670079,68,98,36,320,11
09,201,01007,1,1,30,9,84,7,16,3,1,28,82,58,485338,110,23,4,93,2
09,201,01008,1,4,190,44,200,29,47,33,1,44,64,269,937483,108,76,34,244,5
09,201,01009,3,2,34,79,55,43,14,10,17,58,10,60,351557,68,57,27,134,5
09,202,01010,2,3,64,26,102,12,15,12,4,15,22,70,558979,37,27,16,128,5
09,202,01011,2,0,0,27,36,18,5,0,2,18,2,40,317355,20,23,2,63,2
09,202,01012,3,4,75,19,63,16,38,10,6,25,94,128,560298,119,54,16,82,7
10,203,01013,0,0,0,91,0,48,0,0,0,50,0,0,309874,50,48,0,91,0
10,203,01014,0,0,0,71,67,32,8,0,0,29,6,13,249063,35,40,0,138,0
10,203,01015,0,0,0,71,0,39,0,0,0,49,0,0,208096,49,39,0,71,0
10,203,01016,0,0,0,66,0,31,0,0,0,26,0,0,190741,26,31,0,66,0
10,203,01017,0,0,0,163,42,56,5,0,0,57,9,11,377841,66,61,0,205,0
10,203,01018,0,0,0,113,0,65,0,0,0,50,0,0,230162,50,65,0,113,0
10,203,01019,0,2,36,129,34,52,19,10,0,57,9,68,397968,66,71,10,163,2
10,203,01020,0,0,0,12,0,6,0,0,0,4,0,0,38592,4,6,0,12,0
10,203,01021,0,0,0,39,0,18,0,0,0,36,0,0,89608,36,18,0,39,0
10,203,01022,0,0,0,38,0,11,0,0,0,13,0,0,66154,13,11,0,38,0
10,203,01023,0,0,0,41,0,13,0,0,0,6,0,0,52766,6,13,0,41,0
10,203,01024,0,0,0,85,0,33,0,0,0,58,0,0,243488,58,33,0,85,0
10,203,01025,0,0,0,73,19,37,13,0,0,40,5,104,297748,45,50,0,92,0
10,203,01026,0,0,0,75,0,36,0,0,0,51,0,0,189449,51,36,0,75,0
10,203,01027,0,0,0,241,0,107,0,0,0,82,0,0,329324,82,107,0,241,0
10,203,01028,0,2,400,36,106,15,56,25,0,14,36,490,224200,50,71,25,142,2
10,203,01029,0,0,0,51,0,22,0,0,0,22,2,0,206098,24,22,0,51,0
10,203,01030,0,0,0,95,0,46,0,0,0,47,0,0,233575,47,46,0,95,0
10,204,01031,0,1,106,90,52,63,14,3,0,30,18,142,232028,48,77,3,142,1
10,204,01032,0,0,0,48,0,49,0,0,0,53,0,0,203513,53,49,0,48,0
10,204,01033,0,0,0,68,0,58,0,0,0,19,0,0,200998,19,58,0,68,0
10,204,01034,0,1,100,61,19,49,16,1,0,31,8,131,230807,39,65,1,80,1
10,204,01035,0,0,0,43,0,35,0,0,0,20,0,0,162684,20,35,0,43,0
10,204,01036,0,0,0,102,0,89,0,0,0,39,0,0,170758,39,89,0,102,0
10,204,01037,0,0,0,23,0,20,0,0,0,7,0,0,116863,7,20,0,23,0
10,204,01038,0,0,0,85,0,55,0,0,0,22,0,0,174864,22,55,0,85,0
10,204,01039,0,0,0,92,27,78,22,0,0,41,6,52,318144,47,100,0,119,0
10,204,01040,0,0,0,94,0,76,0,0,0,34,0,0,276809,34,76,0,94,0
10,204,01041,0,1,100,78,81,60,42,14,0,23,43,175,363976,66,102,14,159,1
10,204,01042,0,0,0,71,0,61,0,0,0,23,0,0,180366,23,61,0,71,0
10,204,01043,0,0,0,83,0,67,0,0,0,29,0,0,222551,29,67,0,83,0
10,204,01044,0,0,0,81,0,59,0,0,0,26,0,0,183018,26,59,0,81,0
10,204,01045,0,1,40,40,6,36,9,4,0,17,3,50,163923,20,45,4,46,1
10,204,01046,0,0,0,19,0,12,0,0,0,5,0,0,144071,5,12,0,19,0
10,204,01047,0,0,0,44,10,37,15,0,0,15,2,18,194573,17,52,0,54,0
10,204,01048,0,0,0,176,0,90,0,0,0,68,0,0,267551,68,90,0,176,0
10,204,01049,0,0,0,49,0,37,0,0,0,11,0,0,168788,11,37,0,49,0
10,204,01050,0,0,0,15,0,12,0,0,0,6,0,0,77089,6,12,0,15,0
10,204,01051,0,0,0,72,57,56,15,0,0,22,8,32,216276,30,71,0,129,0
10,204,01052,0,1,40,44,25,42,20,7,0,14,14,78,146216,28,62,7,69,1
10,204,01053,0,0,0,94,0,82,0,0,0,43,0,0,166445,43,82,0,94,0
10,204,01054,0,0,0,11,0,5,0,0,0,3,0,0,80329,3,5,0,11,0
10,204,01055,0,0,0,58,50,46,12,0,0,18,28,16,160760,46,58,0,108,0
10,204,01056,0,0,0,45,0,34,0,0,0,13,0,0,102808,13,34,0,45,0
10,204,01057,0,0,0,74,36,66,5,0,0,26,3,6,173091,29,71,0,110,0
10,205,01058,0,0,0,21,0,10,0,0,0,14,0,0,91949,14,10,0,21,0
10,205,01059,0,0,0,27,0,13,0,0,0,20,0,0,117948,20,13,0,27,0
10,205,01060,0,1,50,42,136,25,33,20,0,35,17,77,155252,52,58,20,178,1
10,205,01061,0,0,0,23,0,14,0,0,0,15,0,0,93398,15,14,0,23,0
10,205,01062,0,0,0,30,0,20,0,0,0,19,0,0,197619,19,20,0,30,0
10,206,01063,0,0,0,47,38,36,10,0,0,14,2,8,132154,16,46,0,85,0
10,206,01064,0,0,0,69,0,48,0,0,0,29,0,0,122239,29,48,0,69,0
10,206,01065,0,0,0,53,0,41,0,0,0,20,0,0,102785,20,41,0,53,0
10,206,01066,0,0,0,104,0,71,0,0,0,34,0,0,251248,34,71,0,104,0
10,206,01067,0,0,0,159,0,117,0,0,0,63,0,0,338222,63,117,0,159,0
10,206,01068,0,0,0,108,0,82,0,0,0,43,0,0,209945,43,82,0,108,0
10,206,01069,0,0,0,108,0,82,0,0,0,35,0,0,262527,35,82,0,108,0
10,206,01070,0,0,0,79,0,58,0,0,0,22,0,0,206979,22,58,0,79,0
10,206,01071,0,0,0,51,0,33,0,0,0,13,0,0,86016,13,33,0,51,0
10,206,01072,0,0,0,46,18,32,6,0,0,12,4,6,120893,16,38,0,64,0
10,206,01073,0,0,0,157,0,114,0,0,0,60,0,0,372566,60,114,0,157,0
10,206,01074,0,1,90,110,125,72,28,8,0,33,14,133,438216,47,100,8,235,1
10,206,01075,0,0,0,90,0,63,0,0,0,23,0,0,215496,23,63,0,90,0
10,206,01076,0,0,0,37,0,28,0,0,0,12,0,0,79308,12,28,0,37,0
10,206,01077,0,0,0,56,10,41,8,0,0,14,4,20,171565,18,49,0,66,0
10,206,01078,0,0,0,61,0,43,0,0,0,21,0,0,182429,21,43,0,61,0
10,206,01079,0,0,0,41,0,31,0,0,0,13,0,0,130884,13,31,0,41,0
10,207,01080,0,0,0,40,0,28,0,0,0,23,0,0,134704,23,28,0,40,0
10,207,01081,0,0,0,42,0,33,0,0,0,22,0,0,196251,22,33,0,42,0
10,207,01082,0,0,0,41,0,37,0,0,0,34,0,0,173499,34,37,0,41,0
10,207,01083,0,0,0,15,46,13,12,0,0,21,2,28,193700,23,25,0,61,0
10,207,01084,0,0,0,38,0,29,0,0,0,23,0,0,175561,23,29,0,38,0
10,207,01085,0,0,0,69,0,58,0,0,0,34,0,0,212127,34,58,0,69,0
10,207,01086,0,0,0,51,0,30,0,0,0,32,0,0,208317,32,30,0,51,0
10,207,01087,0,0,0,24,0,19,0,0,0,18,0,0,166018,18,19,0,24,0
10,207,01088,0,0,0,45,0,30,0,0,0,23,0,0,217331,23,30,0,45,0
10,207,01089,0,0,0,31,0,24,0,0,0,19,0,0,143583,19,24,0,31,0
10,207,01090,0,0,0,19,0,15,0,0,0,16,0,0,117282,16,15,0,19,0
10,207,01091,0,0,0,73,0,58,0,0,0,57,0,0,361358,57,58,0,73,0
10,207,01092,0,0,0,58,0,47,0,0,0,52,0,0,320704,52,47,0,58,0
10,207,01093,0,1,175,24,78,18,33,19,0,47,12,240,323592,59,51,19,102,1
10,207,01094,0,0,0,88,0,58,0,0,0,66,0,0,270594,66,58,0,88,0
10,207,01095,0,0,0,62,0,44,1,0,0,37,0,0,246933,37,45,0,62,0
10,207,01096,0,0,0,58,0,39,0,0,0,27,0,0,191680,27,39,0,58,0
10,207,01097,0,1,50,64,21,41,11,7,0,43,10,52,205508,53,52,7,85,1
10,207,01098,0,0,0,24,11,23,4,0,0,20,6,30,193088,26,27,0,35,0
10,207,01099,0,0,0,31,0,22,0,0,0,35,0,0,167841,35,22,0,31,0
10,207,01100,0,0,0,71,0,52,0,0,0,46,0,0,267606,46,52,0,71,0
10,208,01101,0,0,0,21,18,13,14,0,0,10,2,51,98435,12,27,0,39,0
10,208,01102,0,0,0,24,21,13,9,0,0,13,8,60,201982,21,22,0,45,0
10,208,01103,0,0,0,46,0,27,0,0,0,23,0,0,286456,23,27,0,46,0
10,208,01104,0,0,0,28,0,22,0,0,0,18,0,0,106884,18,22,0,28,0
10,208,01105,0,0,0,51,0,33,0,0,0,20,0,0,215643,20,33,0,51,0
10,208,01106,0,0,0,24,0,16,0,0,0,15,0,0,122772,15,16,0,24,0
10,208,01107,0,0,0,40,0,28,0,0,0,20,0,0,167669,20,28,0,40,0
10,208,01108,0,0,0,66,0,34,0,0,0,26,0,0,145136,26,34,0,66,0
10,208,01109,0,1,100,66,49,42,21,12,0,28,4,144,360198,32,63,12,115,1
10,208,01110,0,0,0,65,0,42,0,0,0,45,0,0,201399,45,42,0,65,0
10,208,01111,0,0,0,119,0,70,0,0,0,45,0,0,322477,45,70,0,119,0
10,209,01112,0,0,0,107,0,39,0,0,0,32,0,0,351741,32,39,0,107,0
10,209,01113,0,0,0,44,24,16,14,0,0,25,10,90,486120,35,30,0,68,0
10,209,01114,0,0,0,71,0,36,0,0,0,37,0,0,230835,37,36,0,71,0
10,209,01115,0,0,0,88,0,52,0,0,0,47,0,0,398977,47,52,0,88,0
10,209,01116,0,1,100,71,95,34,22,7,0,32,15,125,465489,47,56,7,166,1
10,209,01117,0,0,0,89,0,29,0,0,0,24,0,0,149231,24,29,0,89,0
10,209,01118,0,0,0,24,0,13,0,0,0,11,0,0,158506,11,13,0,24,0
10,209,01119,0,0,0,68,0,31,0,0,0,34,0,0,248350,34,31,0,68,0
10,209,01120,0,0,0,63,0,39,0,0,0,32,0,0,322192,32,39,0,63,0
10,210,01121,0,0,0,49,0,30,0,0,0,15,0,0,141023,15,30,0,49,0
10,210,01122,0,0,0,63,0,44,0,0,0,29,0,0,208356,29,44,0,63,0
10,210,01123,0,0,0,41,25,21,18,0,0,15,6,51,291636,21,39,0,66,0
10,210,01124,0,0,0,47,0,22,0,0,0,24,0,0,262450,24,22,0,47,0
10,210,01125,0,0,0,97,24,41,13,0,0,38,5,45,253575,43,54,0,121,0
10,210,01126,0,0,0,62,0,27,0,0,0,84,0,0,292117,84,27,0,62,0
10,210,01127,0,1,107,11,377,8,33,8,0,4,29,547,241026,33,41,8,388,1
10,211,01128,0,0,0,36,72,20,15,0,0,15,4,50,351298,19,35,0,108,0
10,211,01129,0,0,0,48,0,22,0,0,0,13,0,0,208999,13,22,0,48,0
10,211,01130,0,0,0,39,0,19,0,0,0,7,0,0,161685,7,19,0,39,0
10,211,01131,0,0,0,72,0,34,0,0,0,21,0,0,234686,21,34,0,72,0
10,211,01132,0,0,0,53,0,29,0,0,0,20,0,0,288068,20,29,0,53,0
10,211,01133,0,0,0,60,0,31,0,0,0,18,0,0,230468,18,31,0,60,0
10,211,01134,0,1,500,50,175,19,45,30,0,7,6,565,445249,13,64,30,225,1
10,211,01135,0,0,0,48,51,17,16,0,0,9,2,16,188265,11,33,0,99,0
10,211,01136,0,0,0,27,0,16,0,0,0,7,0,0,110058,7,16,0,27,0
10,211,01137,0,0,0,49,0,20,0,0,0,10,0,0,112946,10,20,0,49,0
10,211,01138,0,0,0,108,0,45,0,0,0,20,0,0,290492,20,45,0,108,0
10,211,01139,0,0,0,94,0,63,0,0,0,31,0,0,193127,31,63,0,94,0
10,211,01140,0,0,0,124,0,58,0,0,0,57,0,0,227603,57,58,0,124,0
10,211,01141,0,0,0,82,0,38,0,0,0,31,0,0,221085,31,38,0,82,0
10,212,01142,0,0,0,41,0,38,0,0,0,26,0,0,155579,26,38,0,41,0
10,212,01143,0,0,0,57,0,57,0,0,0,46,0,0,282813,46,57,0,57,0
10,212,01144,0,0,0,11,0,11,0,0,0,8,0,0,55906,8,11,0,11,0
10,212,01145,0,0,0,48,0,43,0,0,0,41,0,0,346453,41,43,0,48,0
10,212,01146,0,0,0,9,0,9,0,0,0,48,0,0,158902,48,9,0,9,0
10,212,01147,0,0,0,46,0,35,0,0,0,30,100,0,344092,130,35,0,46,0
10,212,01148,0,0,0,27,0,26,0,0,0,28,0,0,315415,28,26,0,27,0
10,212,01149,0,0,0,20,0,18,0,0,0,25,0,0,144268,25,18,0,20,0
10,212,01150,0,0,0,28,0,21,0,0,0,23,0,0,68055,23,21,0,28,0
10,212,01151,0,3,662,2,878,3,337,286,0,6,54,824,321817,60,340,286,880,3
10,212,01152,0,0,0,22,0,18,0,0,0,13,0,0,84257,13,18,0,22,0
10,212,01153,0,0,0,43,0,40,0,0,0,27,0,0,285339,27,40,0,43,0
10,212,01154,0,0,0,22,0,18,0,0,0,14,0,0,84486,14,18,0,22,0
10,212,01155,0,0,0,5,0,3,0,0,0,3,0,0,63928,3,3,0,5,0
10,212,01156,0,0,0,37,12,51,17,0,0,30,5,38,191407,35,68,0,49,0
10,212,01157,0,0,0,41,0,32,0,0,0,26,0,0,167398,26,32,0,41,0
10,213,01158,0,0,0,9,0,4,0,0,0,4,0,0,82522,4,4,0,9,0
10,213,01159,0,0,0,29,16,12,4,0,0,15,7,6,134159,22,16,0,45,0
10,213,01160,0,0,0,24,0,17,0,0,0,12,0,0,91818,12,17,0,24,0
10,213,01161,0,1,300,46,18,27,20,9,0,75,8,345,245847,83,47,9,64,1
10,213,01162,0,0,0,19,0,11,0,0,0,9,0,0,106222,9,11,0,19,0
10,213,01163,0,0,0,46,0,24,0,0,0,23,0,0,243613,23,24,0,46,0
10,213,01164,0,0,0,41,19,8,6,0,0,20,1,12,214322,21,14,0,60,0
10,213,01165,0,0,0,19,0,9,0,0,0,10,0,0,126020,10,9,0,19,0
10,213,01166,0,0,0,50,0,29,0,0,0,25,0,0,135534,25,29,0,50,0
10,213,01167,0,0,0,57,0,48,0,0,0,20,0,0,189146,20,48,0,57,0
10,213,01168,0,0,0,40,0,11,0,0,0,28,0,0,104436,28,11,0,40,0
10,213,01169,0,0,0,41,0,25,0,0,0,20,0,0,175401,20,25,0,41,0
10,213,01170,0,0,0,30,0,12,0,0,0,15,0,0,152641,15,12,0,30,0
10,214,01171,0,0,0,44,0,40,0,0,0,39,0,0,161784,39,40,0,44,0
10,214,01172,0,0,0,21,0,14,0,0,0,14,0,0,151060,14,14,0,21,0
10,214,01173,0,0,0,29,0,15,0,0,0,17,0,0,206774,17,15,0,29,0
10,214,01174,0,1,208,14,104,9,10,8,0,6,8,208,298345,14,19,8,118,1
10,214,01175,0,0,0,29,0,24,0,0,0,18,0,0,214166,18,24,0,29,0
10,214,01176,0,0,0,36,0,23,0,0,0,12,0,0,128322,12,23,0,36,0
10,214,01177,0,0,0,39,0,26,0,0,0,33,0,0,235841,33,26,0,39,0
10,214,01178,0,0,0,49,0,36,0,0,0,40,0,0,280582,40,36,0,49,0
10,214,01179,0,0,0,35,0,27,0,0,0,15,0,0,132836,15,27,0,35,0
10,214,01180,0,0,0,8,0,4,0,0,0,5,0,0,90902,5,4,0,8,0
10,215,01181,0,0,0,87,0,42,0,0,0,35,0,0,264209,35,42,0,87,0
10,215,01182,0,0,0,58,0,39,0,0,0,30,0,0,267525,30,39,0,58,0
10,215,01183,0,0,0,149,0,82,0,0,0,72,0,0,270722,72,82,0,149,0
10,215,01184,0,1,1030,69,297,39,174,150,0,39,42,1270,576959,81,213,150,366,1
10,215,01185,0,0,0,98,0,68,0,0,0,41,0,0,228618,41,68,0,98,0
10,215,01186,0,0,0,39,0,24,0,0,0,20,0,0,123292,20,24,0,39,0
10,215,01187,0,0,0,33,0,24,0,0,0,18,0,0,143797,18,24,0,33,0
10,215,01188,0,2,81,31,16,20,8,2,0,26,5,102,250335,31,28,2,47,2
10,215,01189,0,0,0,42,5,25,6,0,0,27,2,10,261752,29,31,0,47,0
10,215,01190,0,0,0,29,0,15,0,0,0,13,0,0,154626,13,15,0,29,0
10,215,01191,0,0,0,8,0,4,0,0,0,5,0,0,148051,5,4,0,8,0
10,215,01192,0,0,0,67,0,37,0,0,0,46,0,0,302645,46,37,0,67,0
10,215,01193,0,0,0,42,0,22,0,0,0,21,0,0,286113,21,22,0,42,0
10,215,01194,0,0,0,31,0,20,0,0,0,17,0,0,133182,17,20,0,31,0
10,215,01195,0,0,0,6,0,3,0,0,0,3,0,0,81423,3,3,0,6,0
10,215,01196,0,0,0,22,0,17,0,0,0,75,0,0,152112,75,17,0,22,0
10,215,01197,0,0,0,27,0,17,0,0,0,45,0,0,162870,45,17,0,27,0
10,215,01198,0,0,0,22,0,13,0,0,0,9,0,0,128817,9,13,0,22,0
10,216,01199,0,0,0,23,83,16,16,0,0,12,11,41,241438,23,32,0,106,0
10,216,01200,0,0,0,46,24,28,14,0,0,39,6,26,406795,45,42,0,70,0
10,216,01201,0,0,0,80,0,49,0,0,0,21,0,0,361662,21,49,0,80,0
10,216,01202,0,0,0,57,0,48,0,0,0,25,0,0,331651,25,48,0,57,0
10,216,01203,0,0,0,57,0,34,0,0,0,22,0,0,164858,22,34,0,57,0
10,216,01204,0,0,0,35,102,22,20,0,0,34,8,24,272858,42,42,0,137,0
10,216,01205,0,0,0,72,0,61,0,0,0,52,0,0,340875,52,61,0,72,0
10,216,01206,0,0,0,73,0,47,0,0,0,102,0,0,245645,102,47,0,73,0
10,216,01207,0,0,0,65,0,37,0,0,0,22,0,0,290540,22,37,0,65,0
10,216,01208,0,0,0,96,0,44,0,0,0,32,0,0,244775,32,44,0,96,0
10,216,01209,0,0,0,93,0,50,0,0,0,44,0,0,259671,44,50,0,93,0
10,216,01210,0,0,0,40,0,26,0,0,0,15,0,0,124057,15,26,0,40,0
10,216,01211,0,0,0,29,0,15,0,0,0,14,0,0,90482,14,15,0,29,0
10,216,01212,0,4,1121,130,303,101,172,115,0,128,125,1509,683049,253,273,115,433,4
10,216,01213,0,0,0,171,0,54,0,0,0,87,0,0,435627,87,54,0,171,0
10,216,01214,0,0,0,88,0,43,0,0,0,36,0,0,306825,36,43,0,88,0
10,217,01215,0,0,0,74,17,83,11,0,0,29,3,40,130772,32,94,0,91,0
10,217,01216,0,0,0,5,0,5,0,0,0,56,0,0,132925,56,5,0,5,0
10,217,01217,0,0,0,74,0,33,0,0,0,19,0,0,178142,19,33,0,74,0
10,217,01218,0,0,0,18,0,16,0,0,0,11,0,0,99907,11,16,0,18,0
10,217,01219,0,0,0,65,0,63,0,0,0,27,0,0,331961,27,63,0,65,0
10,217,01220,0,0,0,19,0,18,0,0,0,6,0,0,130728,6,18,0,19,0
10,217,01221,0,0,0,51,21,49,10,0,0,16,2,45,221804,18,59,0,72,0
10,217,01222,0,0,0,32,7,31,21,0,0,12,9,159,177633,21,52,0,39,0
10,217,01223,0,0,0,39,0,33,0,0,0,12,0,0,116082,12,33,0,39,0
10,217,01224,0,4,80,18,108,19,44,20,0,8,46,200,219527,54,63,20,126,4
10,217,01225,0,0,0,26,0,23,0,0,0,18,0,0,199383,18,23,0,26,0
10,217,01226,0,0,0,52,2,55,2,0,0,28,1,6,263876,29,57,0,54,0
10,217,01227,0,0,0,13,0,13,0,0,0,4,0,0,141563,4,13,0,13,0
10,217,01228,0,0,0,89,0,100,0,0,0,31,0,0,217165,31,100,0,89,0
10,218,01229,0,0,0,45,0,9,0,0,0,42,0,0,90714,42,9,0,45,0
10,218,01230,0,1,80,34,101,13,52,1,0,45,34,206,340983,79,65,1,135,1
10,218,01231,0,0,0,124,0,27,0,0,0,81,0,0,321292,81,27,0,124,0
10,218,01232,0,0,0,58,0,14,0,0,0,34,0,0,223709,34,14,0,58,0
10,218,01233,0,0,0,23,0,10,0,0,0,23,0,0,128899,23,10,0,23,0
10,218,01234,0,0,0,36,0,16,0,0,0,25,0,0,105216,25,16,0,36,0
10,218,01235,0,0,0,56,0,20,0,0,0,38,0,0,220639,38,20,0,56,0
10,218,01236,0,0,0,92,44,27,14,0,0,43,4,12,190217,47,41,0,136,0
10,218,01237,0,0,0,24,0,8,0,0,0,10,0,0,201759,10,8,0,24,0
10,218,01238,0,0,0,112,0,39,0,0,0,46,0,0,182794,46,39,0,112,0
10,218,01239,0,0,0,118,0,59,0,0,0,75,0,0,163721,75,59,0,118,0
10,218,01240,0,1,32,34,29,17,13,7,0,16,5,42,113493,21,30,7,63,1
10,218,01241,0,0,0,16,0,5,0,0,0,71,0,0,128155,71,5,0,16,0
10,218,01242,0,0,0,64,0,25,0,0,0,57,0,0,174306,57,25,0,64,0
10,218,01243,0,0,0,79,0,25,0,0,0,42,0,0,110027,42,25,0,79,0
10,218,01244,0,0,0,85,0,26,0,0,0,37,0,0,157628,37,26,0,85,0
10,218,01245,0,0,0,51,0,22,0,0,0,23,0,0,149580,23,22,0,51,0
10,218,01246,0,0,0,44,0,7,0,0,0,39,0,0,173200,39,7,0,44,0
10,218,01247,0,0,0,70,0,20,0,0,0,49,0,0,153953,49,20,0,70,0
10,219,01248,0,0,0,26,0,12,0,0,0,12,0,0,188899,12,12,0,26,0
10,219,01249,0,0,0,16,0,11,0,0,0,66,0,0,121691,66,11,0,16,0
10,219,01250,0,0,0,82,0,41,0,0,0,23,0,0,138675,23,41,0,82,0
10,219,01251,0,0,0,19,0,9,0,0,0,8,0,0,146822,8,9,0,19,0
10,219,01252,0,0,0,75,0,17,0,0,0,60,0,0,262646,60,17,0,75,0
10,219,01253,0,0,0,16,0,9,0,0,0,67,0,0,79950,67,9,0,16,0
10,219,01254,0,0,0,97,0,26,0,0,0,42,0,0,214445,42,26,0,97,0
10,219,01255,0,0,0,25,0,6,0,0,0,20,0,0,268073,20,6,0,25,0
10,219,01256,0,0,0,75,0,30,0,0,0,23,0,0,174156,23,30,0,75,0
10,219,01257,0,0,0,39,11,12,10,0,0,12,8,12,119652,20,22,0,50,0
10,219,01258,0,2,294,40,1368,16,166,105,0,26,74,948,442608,100,182,105,1408,2
10,219,01259,0,0,0,20,0,8,0,0,0,35,0,0,124028,35,8,0,20,0
10,219,01260,0,0,0,25,56,11,5,0,0,17,11,6,265123,28,16,0,81,0
10,219,01261,0,0,0,86,0,33,0,0,0,72,0,0,200384,72,33,0,86,0
10,219,01262,0,0,0,18,0,10,0,0,0,7,0,0,84662,7,10,0,18,0
10,219,01263,0,0,0,38,0,11,0,0,0,23,0,0,155780,23,11,0,38,0
10,219,01264,0,0,0,90,0,23,0,0,0,47,0,0,296153,47,23,0,90,0
10,219,01265,0,0,0,80,0,37,0,0,0,60,0,0,268136,60,37,0,80,0
10,219,01266,0,0,0,24,22,7,10,0,0,9,7,8,129552,16,17,0,46,0
10,219,01267,0,2,135,58,120,15,54,27,0,25,10,200,270096,35,69,27,178,2
10,220,01268,0,0,0,67,0,21,0,0,0,46,0,0,187461,46,21,0,67,0
10,220,01269,0,0,0,55,0,15,0,0,0,17,0,0,95651,17,15,0,55,0
10,220,01270,0,1,33,155,24,19,12,8,0,48,9,33,265384,57,31,8,179,1
10,220,01271,0,0,0,196,0,25,0,0,0,94,0,0,207690,94,25,0,196,0
10,220,01272,0,0,0,107,0,13,0,0,0,39,0,0,177511,39,13,0,107,0
10,220,01273,0,0,0,58,0,8,0,0,0,14,0,0,131004,14,8,0,58,0
10,220,01274,0,0,0,100,0,15,0,0,0,31,0,0,370182,31,15,0,100,0
10,220,01275,0,0,0,114,0,14,0,0,0,52,0,0,284514,52,14,0,114,0
10,220,01276,0,0,0,157,0,24,0,0,0,54,0,0,276217,54,24,0,157,0
10,220,01277,0,0,0,45,0,6,0,0,0,13,0,0,158089,13,6,0,45,0
10,220,01278,0,1,120,145,58,5,17,11,0,77,18,120,443839,95,22,11,203,1
10,220,01279,0,0,0,89,0,26,0,0,0,28,0,0,232813,28,26,0,89,0
10,220,01280,0,0,0,113,0,10,0,0,0,48,0,0,268830,48,10,0,113,0
10,220,01281,0,0,0,36,0,6,0,0,0,16,0,0,87579,16,6,0,36,0
10,220,01282,0,0,0,66,0,15,0,0,0,38,0,0,127368,38,15,0,66,0
10,220,01283,0,0,0,79,21,6,5,0,0,30,10,6,180339,40,11,0,100,0
10,221,01284,0,0,0,85,0,18,0,0,0,26,0,0,310397,26,18,0,85,0
10,221,01285,0,0,0,107,1,12,1,0,0,33,2,1,216123,35,13,0,108,0
10,221,01286,0,0,0,25,0,9,0,0,0,7,0,0,193825,7,9,0,25,0
10,221,01287,0,0,0,60,0,6,0,0,0,20,0,0,195729,20,6,0,60,0
10,221,01288,0,5,312,103,107,12,52,12,0,39,77,482,346076,116,64,12,210,5
10,221,01289,0,0,0,116,0,24,0,0,0,41,0,0,132932,41,24,0,116,0
10,221,01290,0,0,0,76,0,22,0,0,0,31,0,0,161584,31,22,0,76,0
10,221,01291,0,0,0,84,0,18,0,0,0,45,0,0,186021,45,18,0,84,0
10,221,01292,0,0,0,95,0,19,0,0,0,37,0,0,179956,37,19,0,95,0
10,221,01293,0,0,0,50,0,10,0,0,0,16,0,0,114996,16,10,0,50,0
10,221,01294,0,0,0,82,0,19,0,0,0,27,0,0,184491,27,19,0,82,0
10,221,01295,0,0,0,176,0,23,0,0,0,59,0,0,254808,59,23,0,176,0
10,221,01296,0,0,0,66,0,16,0,0,0,21,0,0,152912,21,16,0,66,0
10,221,01297,0,0,0,72,26,0,14,0,0,18,17,90,208771,35,14,0,98,0
10,221,01298,0,0,0,105,0,18,0,0,0,40,0,0,297794,40,18,0,105,0
10,221,01299,0,0,0,113,0,45,0,0,0,45,0,0,338149,45,45,0,113,0
10,221,01300,0,0,0,41,52,7,17,0,0,12,4,30,200574,16,24,0,93,0
10,221,01301,0,0,0,74,0,27,0,0,0,24,0,0,210035,24,27,0,74,0
10,221,01302,0,0,0,72,0,14,0,0,0,21,0,0,227388,21,14,0,72,0
10,221,01303,0,0,0,40,0,13,0,0,0,12,0,0,148565,12,13,0,40,0
10,222,01304,0,0,0,9,0,5,0,0,0,4,0,0,90343,4,5,0,9,0
10,222,01305,0,0,0,74,0,21,0,0,0,19,0,0,124191,19,21,0,74,0
10,222,01306,0,0,0,18,0,8,0,0,0,9,0,0,111094,9,8,0,18,0
10,222,01307,0,0,0,31,0,13,0,0,0,12,0,0,146680,12,13,0,31,0
10,222,01308,0,0,0,97,0,26,0,0,0,34,0,0,172632,34,26,0,97,0
10,222,01309,0,0,0,18,0,6,0,0,0,12,0,0,80457,12,6,0,18,0
10,222,01310,0,0,0,60,0,18,0,0,0,18,0,0,195785,18,18,0,60,0
10,222,01311,0,2,100,47,13,14,41,8,0,13,43,208,257619,56,55,8,60,2
10,222,01312,0,1,100,79,36,21,33,15,0,19,13,125,273414,32,54,15,115,1
10,222,01313,0,0,0,18,0,7,0,0,0,6,0,0,97467,6,7,0,18,0
10,222,01314,0,1,108,130,71,40,25,21,0,57,22,118,540009,79,65,21,201,1
10,222,01315,0,0,0,17,0,5,0,0,0,6,0,0,103357,6,5,0,17,0
10,222,01316,0,0,0,22,0,6,0,0,0,5,0,0,140097,5,6,0,22,0
10,222,01317,0,0,0,22,0,9,0,0,0,7,0,0,77256,7,9,0,22,0
10,222,01318,0,0,0,70,0,30,0,0,0,21,0,0,194172,21,30,0,70,0
10,222,01319,0,0,0,45,19,11,12,0,0,15,18,46,182178,33,23,0,64,0
10,222,01320,0,0,0,68,0,24,0,0,0,21,0,0,152721,21,24,0,68,0
10,222,01321,0,0,0,29,0,9,0,0,0,8,0,0,30777,8,9,0,29,0
10,223,01322,0,0,0,132,0,71,0,0,0,70,0,0,282127,70,71,0,132,0
10,223,01323,0,1,42,120,80,60,35,8,0,41,22,229,381352,63,95,8,200,1
10,223,01324,0,0,0,51,0,29,0,0,0,16,0,0,88511,16,29,0,51,0
10,223,01325,0,0,0,59,0,33,0,0,0,19,0,0,153831,19,33,0,59,0
10,223,01326,0,0,0,106,0,54,0,0,0,31,0,0,200223,31,54,0,106,0
10,223,01327,0,0,0,138,4,73,11,0,0,42,2,30,316743,44,84,0,142,0
10,223,01328,0,0,0,84,0,49,0,0,0,36,0,0,244066,36,49,0,84,0
10,224,01329,0,0,0,20,0,6,0,0,0,14,0,0,106701,14,6,0,20,0
10,224,01330,0,0,0,60,0,22,0,0,0,25,0,0,123376,25,22,0,60,0
10,224,01331,0,0,0,82,0,26,0,0,0,46,0,0,132875,46,26,0,82,0
10,224,01332,0,0,0,39,30,7,9,0,0,14,3,60,154428,17,16,0,69,0
10,224,01333,0,0,0,33,0,11,0,0,0,11,0,0,90284,11,11,0,33,0
10,224,01334,0,0,0,42,0,16,0,0,0,15,0,0,94952,15,16,0,42,0
10,224,01335,0,0,0,154,0,28,0,0,0,54,0,0,285316,54,28,0,154,0
10,224,01336,0,0,0,129,5,21,4,0,0,67,15,8,365138,82,25,0,134,0
10,224,01337,0,0,0,22,0,10,0,0,0,9,0,0,43440,9,10,0,22,0
10,224,01338,0,0,0,39,9,13,7,0,0,25,3,19,142743,28,20,0,48,0
10,224,01339,0,1,60,39,8,5,45,10,0,12,3,145,151242,15,50,10,47,1
10,224,01340,0,0,0,201,117,49,14,0,0,65,2,42,247949,67,63,0,318,0
10,224,01341,0,0,0,122,0,26,0,0,0,37,0,0,188049,37,26,0,122,0
10,224,01342,0,0,0,48,0,16,0,0,0,17,0,0,146176,17,16,0,48,0
10,224,01343,0,5,455,45,120,15,51,38,0,22,31,456,572040,53,66,38,165,5
10,224,01344,0,0,0,47,0,23,0,0,0,23,0,0,192397,23,23,0,47,0
10,225,01345,0,0,0,143,0,85,0,0,0,47,0,0,173840,47,85,0,143,0
10,225,01346,0,0,0,90,110,56,14,0,0,39,4,30,226524,43,70,0,200,0
10,225,01347,0,0,0,81,0,49,0,0,0,41,0,0,197548,41,49,0,81,0
10,225,01348,0,0,0,151,0,81,0,0,0,60,0,0,239496,60,81,0,151,0
10,225,01349,0,0,0,52,0,24,0,0,0,49,0,0,149150,49,24,0,52,0
10,225,01350,0,1,100,22,43,10,23,7,0,6,20,185,217242,26,33,7,65,1
10,225,01351,0,0,0,43,0,28,0,0,0,17,0,0,125201,17,28,0,43,0
10,225,01352,0,0,0,52,0,31,0,0,0,55,0,0,167535,55,31,0,52,0
10,225,01353,0,0,0,98,0,46,0,0,0,58,0,0,165319,58,46,0,98,0
10,225,01354,0,0,0,106,0,50,0,0,0,28,0,0,186152,28,50,0,106,0
10,225,01355,0,0,0,69,0,30,0,0,0,29,0,0,184927,29,30,0,69,0
10,226,01356,0,1,196,9,110,8,33,7,0,13,33,361,347295,46,41,7,119,1
10,226,01357,0,0,0,64,13,32,4,0,0,17,1,9,109323,18,36,0,77,0
10,226,01358,0,1,280,37,66,19,34,10,0,15,8,325,208305,23,53,10,103,1
10,226,01359,0,0,0,46,0,27,0,0,0,19,0,0,131434,19,27,0,46,0
10,226,01360,0,0,0,74,7,38,6,0,0,44,4,17,212305,48,44,0,81,0
10,226,01361,0,0,0,14,32,6,7,0,0,5,3,20,74380,8,13,0,46,0
10,226,01362,0,0,0,28,36,18,16,4,0,17,4,46,110167,21,34,4,64,0
10,226,01363,0,0,0,30,0,20,0,0,0,28,0,0,76266,28,20,0,30,0
10,226,01364,0,0,0,29,0,22,0,0,0,24,0,0,97712,24,22,0,29,0
10,227,01365,0,1,36,78,49,28,13,0,0,25,8,36,128977,33,41,0,127,1
10,227,01366,0,0,0,54,0,16,0,0,0,15,0,0,51496,15,16,0,54,0
10,227,01367,0,0,0,161,0,50,0,0,0,55,0,0,290940,55,50,0,161,0
10,227,01368,0,2,200,57,80,15,62,25,0,17,28,445,221195,45,77,25,137,2
10,227,01369,0,0,0,24,0,5,0,0,0,9,0,0,107144,9,5,0,24,0
10,227,01370,0,0,0,66,0,16,0,0,0,18,0,0,85105,18,16,0,66,0
10,227,01371,0,0,0,99,0,25,0,0,0,29,0,0,115997,29,25,0,99,0
10,228,01372,0,0,0,88,188,6,38,0,0,19,34,141,136167,53,44,0,276,0
10,228,01373,0,0,0,65,0,4,0,0,0,73,0,0,67481,73,4,0,65,0
10,228,01374,0,2,160,156,137,36,80,35,0,42,24,313,198971,66,116,35,293,2
10,228,01375,0,0,0,51,0,6,0,0,0,12,0,0,48345,12,6,0,51,0
10,228,01376,0,0,0,94,0,23,0,0,0,26,0,0,73267,26,23,0,94,0
10,228,01377,0,0,0,117,0,22,0,0,0,35,0,0,112030,35,22,0,117,0
10,229,01378,0,0,0,71,0,27,0,0,0,19,0,0,73951,19,27,0,71,0
10,229,01379,0,0,0,36,0,10,0,0,0,63,0,0,94467,63,10,0,36,0
10,229,01380,0,0,0,114,0,44,0,0,0,35,0,0,176140,35,44,0,114,0
10,229,01381,0,0,0,51,0,19,0,0,0,41,0,0,152156,41,19,0,51,0
10,229,01382,0,0,0,106,0,48,0,0,0,63,0,0,144036,63,48,0,106,0
10,229,01383,0,0,0,25,0,4,0,0,0,19,0,0,61984,19,4,0,25,0
10,229,01384,0,0,0,30,0,13,0,0,0,14,0,0,97083,14,13,0,30,0
10,229,01385,0,0,0,52,0,20,0,0,0,32,0,0,163938,32,20,0,52,0
10,229,01386,0,2,250,111,43,38,42,10,0,55,46,674,494489,101,80,10,154,2
10,229,01387,0,0,0,75,0,26,0,0,0,35,0,0,172351,35,26,0,75,0
10,229,01388,0,0,0,37,0,9,0,0,0,44,0,0,68393,44,9,0,37,0
10,229,01389,0,0,0,41,0,18,0,0,0,16,0,0,70316,16,18,0,41,0
10,229,01390,0,0,0,47,48,14,10,0,0,21,7,30,197309,28,24,0,95,0
10,229,01391,0,0,0,57,9,13,9,0,0,28,26,65,171214,54,22,0,66,0
10,229,01392,0,2,56,65,44,9,30,23,0,39,16,72,232337,55,39,23,109,2
10,229,01393,0,0,0,28,0,5,0,0,0,15,0,0,87387,15,5,0,28,0
10,229,01394,0,0,0,14,61,4,15,0,0,5,3,30,130183,8,19,0,75,0
10,229,01395,0,1,60,48,30,10,16,6,0,25,5,77,151249,30,26,6,78,1
10,229,01396,0,0,0,19,0,10,0,0,0,20,0,0,96845,20,10,0,19,0
10,229,01397,0,0,0,12,0,5,0,0,0,6,0,0,41821,6,5,0,12,0
10,230,01398,0,0,0,54,9,24,14,0,0,124,1,26,268998,125,38,0,63,0
10,230,01399,0,2,321.7142791748047,25,34,11,79.3529167175293,35.07143020629883,0,10,22,492.1111602783203,397817,32,90.352921,35.07143,59,2
10,230,01400,0,11,2072,69,3220,39,537,446,0,29,180,3017,1771075,209,576,446,3289,11
10,230,01401,0,0,0,40,0,20,0,0,0,25,0,0,106866,25,20,0,40,0
10,230,01402,0,0,0,51,181,22,70,0,0,38,17,232,273129,55,92,0,232,0
10,230,01403,0,1,50,84,25,36,14,2,0,52,11,76,261427,63,50,2,109,1
10,230,01404,0,0,0,55,4,20,3,0,0,33,1,6,203567,34,23,0,59,0
10,230,01405,0,0,0,207,8,79,6,0,0,92,3,12,169510,95,85,0,215,0
10,230,01406,0,0,0,54,0,24,0,0,0,28,0,0,124966,28,24,0,54,0
10,230,01407,0,0,0,46,4,14,3,0,0,38,1,0,254904,39,17,0,50,0
10,230,01408,0,0,0,50,59,14,18,0,0,80,9,40,241216,89,32,0,109,0
10,230,01409,0,0,0,100,0,22,0,0,0,53,0,0,211376,53,22,0,100,0
10,230,01410,0,0,0,92,0,19,0,0,0,50,0,0,138143,50,19,0,92,0
10,230,01411,0,0,0,67,5,24,12,0,0,30,10,20,198008,40,36,0,72,0
10,230,01412,0,0,0,36,0,19,0,0,0,15,0,0,75086,15,19,0,36,0
10,230,01413,0,0,0,4,7,2,15,0,0,4,3,23,109504,7,17,0,11,0
10,230,01414,0,0,0,82,102,39,24,0,0,37,7,53,227382,44,63,0,184,0
10,230,01415,0,0,0,42,0,22,0,0,0,17,0,0,90964,17,22,0,42,0
10,230,01416,0,0,0,34,0,19,0,0,0,21,0,0,66139,21,19,0,34,0
10,230,01417,0,1,72,57,85,32,41,13,0,23,25,213,216348,48,73,13,142,1
10,230,01418,0,0,0,36,0,13,0,0,0,16,0,0,154613,16,13,0,36,0
10,230,01419,0,0,0,11,0,7,0,0,0,47,0,0,74898,47,7,0,11,0
10,230,01420,0,0,0,54,61,36,22,0,0,122,29,143,202411,151,58,0,115,0
10,231,01421,0,0,0,75,45,34,7,0,0,36,2,30,212253,38,41,0,120,0
10,231,01422,0,2,153,55,140,26,30,25,0,25,34,165,462616,59,56,25,195,2
10,231,01423,0,0,0,115,0,55,0,0,0,133,0,0,240636,133,55,0,115,0
10,231,01424,0,0,0,70,9,34,8,0,0,32,6,28,202175,38,42,0,79,0
10,231,01425,0,0,0,91,0,49,0,0,0,40,0,0,109673,40,49,0,91,0
10,231,01426,0,0,0,105,0,56,0,0,0,57,0,0,157809,57,56,0,105,0
10,231,01427,0,0,0,64,15,29,11,0,0,35,57,10,178429,92,40,0,79,0
10,231,01428,0,0,0,68,66,36,8,0,0,28,6,20,263946,34,44,0,134,0
10,231,01429,0,0,0,114,7,45,5,0,0,59,6,22,254911,65,50,0,121,0
10,231,01430,0,0,0,67,0,36,0,0,0,31,0,0,101325,31,36,0,67,0
10,231,01431,0,0,0,9,0,4,0,0,0,11,0,0,103262,11,4,0,9,0
10,231,01432,0,0,0,64,0,29,0,0,0,48,0,0,148373,48,29,0,64,0
10,231,01433,0,0,0,92,0,45,0,0,0,50,0,0,182631,50,45,0,92,0
10,231,01434,0,0,0,44,0,22,0,0,0,18,0,0,110276,18,22,0,44,0
10,232,01435,0,0,0,175,0,63,0,0,0,47,0,0,207179,47,63,0,175,0
10,232,01436,0,0,0,43,0,17,0,0,0,10,0,0,42256,10,17,0,43,0
10,232,01437,0,0,0,137,0,67,0,0,0,47,0,0,196070,47,67,0,137,0
10,232,01438,0,0,0,54,0,19,0,0,0,16,0,0,48743,16,19,0,54,0
10,232,01439,0,0,0,30,0,15,0,0,0,5,0,0,33820,5,15,0,30,0
10,232,01440,0,2,78,102,20,50,16,6,0,42,8,84,232606,50,66,6,122,2
10,232,01441,0,3,100,110,335,39,65,13,0,34,26,172,291079,60,104,13,445,3
10,232,01442,0,0,0,94,0,38,0,0,0,25,0,0,103623,25,38,0,94,0
10,232,01443,0,0,0,127,0,41,0,0,0,44,0,0,213358,44,41,0,127,0
10,232,01444,0,0,0,108,0,39,0,0,0,31,0,0,170565,31,39,0,108,0
10,232,01445,0,0,0,172,0,69,0,0,0,56,0,0,166534,56,69,0,172,0
10,233,01446,0,0,0,26,13,10,8,0,0,5,2,34,132452,7,18,0,39,0
10,233,01447,0,0,0,90,0,35,0,0,0,27,0,0,106489,27,35,0,90,0
10,233,01448,0,0,0,182,0,34,0,0,0,40,0,0,165088,40,34,0,182,0
10,233,01449,0,1,40,140,14,27,10,8,0,33,1,44,225107,34,37,8,154,1
10,233,01450,0,0,0,88,0,43,0,0,0,16,0,0,136897,16,43,0,88,0
10,233,01451,0,0,0,617,0,203,0,0,0,159,0,0,133647,159,203,0,617,0
10,233,01452,0,0,0,151,0,18,0,0,0,35,0,0,187468,35,18,0,151,0
10,233,01453,0,1,100,179,67,25,26,9,0,32,11,177,301382,43,51,9,246,1
10,233,01454,0,0,0,39,0,13,0,0,0,32,0,0,88770,32,13,0,39,0
10,233,01455,0,0,0,36,0,17,0,0,0,8,0,0,90950,8,17,0,36,0
10,233,01456,0,0,0,104,0,35,0,0,0,19,0,0,56922,19,35,0,104,0
10,234,01457,0,0,0,86,0,29,0,0,0,57,0,0,169902,57,29,0,86,0
10,234,01458,0,0,0,172,0,66,0,0,0,63,0,0,225424,63,66,0,172,0
10,234,01459,0,0,0,46,3,18,3,0,0,10,1,5,108429,11,21,0,49,0
10,234,01460,0,0,0,50,0,16,0,0,0,15,0,0,57516,15,16,0,50,0
10,234,01461,0,1,38,79,32,24,10,3,0,30,5,38,163501,35,34,3,111,1
10,234,01462,0,0,0,160,0,40,0,0,0,47,0,0,209284,47,40,0,160,0
10,234,01463,0,0,0,77,17,15,11,0,0,16,4,73,138936,20,26,0,94,0
10,234,01464,0,0,0,30,0,11,0,0,0,8,0,0,75213,8,11,0,30,0
10,234,01465,0,0,0,30,0,13,0,0,0,8,0,0,62621,8,13,0,30,0
10,234,01466,0,0,0,0,7,0,5,0,0,15,4,8,173327,19,5,0,7,0
10,234,01467,0,0,0,56,0,21,0,0,0,21,0,0,224899,21,21,0,56,0
10,234,01468,0,0,0,39,2,14,2,0,0,12,30,6,131528,42,16,0,41,0
10,234,01469,0,0,0,121,0,34,0,0,0,32,0,0,94010,32,34,0,121,0
10,234,01470,0,0,0,36,0,14,0,0,0,12,0,0,176055,12,14,0,36,0
10,234,01471,0,2,110,291,142,113,37,8,0,76,41,318,358278,117,150,8,433,2
10,234,01472,0,0,0,70,0,27,0,0,0,18,0,0,120145,18,27,0,70,0
10,234,01473,0,0,0,72,25,21,10,0,0,18,14,12,274989,32,31,0,97,0
10,234,01474,0,0,0,140,3,69,3,0,0,53,2,2,109233,55,72,0,143,0
10,234,01475,0,0,0,93,3,34,3,0,0,25,0,6,86049,25,37,0,96,0
10,235,01476,0,0,0,97,64,15,7,0,0,34,8,10,206854,42,22,0,161,0
10,235,01477,0,0,0,137,9,9,6,0,0,50,3,24,160820,53,15,0,146,0
10,235,01478,0,0,0,294,0,14,0,0,0,113,0,0,234363,113,14,0,294,0
10,235,01479,0,0,0,201,12,5,5,0,0,138,1,6,312312,139,10,0,213,0
10,235,01480,0,0,0,238,13,19,18,0,0,87,1,14,226007,88,37,0,251,0
10,235,01481,0,2,100,203,59,7,8,1,0,76,24,117,283133,100,15,1,262,2
10,235,01482,0,0,0,372,0,15,0,0,0,130,0,0,200031,130,15,0,372,0
10,235,01483,0,2,36,283,13,11,14,6,0,117,17,54,305178,134,25,6,296,2
10,235,01484,0,0,0,422,0,43,0,0,0,214,0,0,226523,214,43,0,422,0
10,235,01485,0,0,0,143,0,16,0,0,0,58,0,0,173187,58,16,0,143,0
10,235,01486,0,0,0,120,0,12,0,0,0,46,0,0,211329,46,12,0,120,0
10,236,01487,0,0,0,75,0,42,0,0,0,54,0,0,201920,54,42,0,75,0
10,236,01488,0,0,0,160,59,49,15,0,0,94,5,22,260511,99,64,0,219,0
10,236,01489,0,0,0,87,0,46,0,0,0,73,0,0,222003,73,46,0,87,0
10,236,01490,0,0,0,108,0,28,0,0,0,57,0,0,176048,57,28,0,108,0
10,236,01491,0,0,0,16,0,6,0,0,0,8,0,0,98603,8,6,0,16,0
10,236,01492,0,0,0,24,0,5,0,0,0,10,0,0,100820,10,5,0,24,0
10,236,01493,0,0,0,40,0,13,0,0,0,17,0,0,82296,17,13,0,40,0
10,236,01494,0,0,0,32,0,16,0,0,0,26,0,0,148418,26,16,0,32,0
10,236,01495,0,3,170,27,423,5,98,18,0,42,83,746,646956,125,103,18,450,3
10,236,01496,0,0,0,55,0,34,0,0,0,26,0,0,101958,26,34,0,55,0
10,236,01497,0,0,0,25,5,7,9,0,0,10,2,13,139379,12,16,0,30,0
10,236,01498,0,0,0,66,0,33,0,0,0,44,0,0,184217,44,33,0,66,0
10,236,01499,0,0,0,36,0,12,0,0,0,17,0,0,104979,17,12,0,36,0
10,236,01500,0,0,0,17,0,14,0,0,0,14,0,0,129574,14,14,0,17,0
10,236,01501,0,0,0,55,0,14,0,0,0,20,0,0,192648,20,14,0,55,0
10,236,01502,0,0,0,49,0,16,0,0,0,33,0,0,128699,33,16,0,49,0
10,236,01503,0,0,0,61,64,21,23,0,0,43,7,23,155391,50,44,0,125,0
10,236,01504,0,0,0,58,0,28,0,0,0,43,0,0,155374,43,28,0,58,0
10,236,01505,0,0,0,42,75,26,7,0,0,32,7,16,236243,39,33,0,117,0
10,236,01506,0,0,0,46,0,11,0,0,0,20,0,0,124921,20,11,0,46,0
10,236,01507,0,0,0,45,0,25,0,0,0,36,0,0,221718,36,25,0,45,0
10,236,01508,0,0,0,75,0,31,0,0,0,44,0,0,235567,44,31,0,75,0
10,236,01509,0,0,0,61,0,9,0,0,0,31,0,0,199990,31,9,0,61,0
10,236,01510,0,0,0,6,0,0,0,0,0,14,0,0,142394,14,0,0,6,0
10,237,01511,0,0,0,82,0,62,0,0,0,30,0,0,124716,30,62,0,82,0
10,237,01512,0,1,43,92,90,87,21,8,0,86,25,91,321491,111,108,8,182,1
10,237,01513,0,0,0,80,13,67,9,0,0,28,8,45,187123,36,76,0,93,0
10,237,01514,0,0,0,65,0,49,0,0,0,20,0,0,71886,20,49,0,65,0
10,237,01515,0,0,0,54,0,41,0,0,0,44,0,0,183066,44,41,0,54,0
10,237,01516,0,0,0,323,0,233,0,0,0,136,0,0,143439,136,233,0,323,0
10,237,01517,0,0,0,26,0,23,0,0,0,48,0,0,162502,48,23,0,26,0
10,237,01518,0,0,0,28,0,25,0,0,0,9,0,0,95454,9,25,0,28,0
10,237,01519,0,0,0,67,0,63,0,0,0,57,0,0,237292,57,63,0,67,0
10,237,01520,0,0,0,28,18,27,5,0,0,21,1,7,141074,22,32,0,46,0
10,237,01521,0,0,0,42,0,36,0,0,0,38,0,0,112042,38,36,0,42,0
10,237,01522,0,0,0,32,0,23,0,0,0,9,0,0,94358,9,23,0,32,0
10,237,01523,0,0,0,42,0,32,0,0,0,12,0,0,178472,12,32,0,42,0
10,237,01524,0,0,0,30,5,23,24,0,0,22,2,30,166127,24,47,0,35,0
10,238,01525,0,0,0,41,0,12,0,0,0,50,0,0,136768,50,12,0,41,0
10,238,01526,0,0,0,46,0,18,0,0,0,27,0,0,148711,27,18,0,46,0
10,238,01527,0,1,100,164,123,37,48,7,0,66,42,530,232075,108,85,7,287,1
10,238,01528,0,0,0,18,0,7,0,0,0,9,0,0,92070,9,7,0,18,0
10,238,01529,0,0,0,63,0,23,0,0,0,34,0,0,124149,34,23,0,63,0
10,238,01530,0,2,39,14,21,8,15,7,0,10,19,39,267399,29,23,7,35,2
10,238,01531,0,0,0,36,0,9,0,0,0,13,0,0,77558,13,9,0,36,0
10,238,01532,0,0,0,15,0,7,0,0,0,11,0,0,235761,11,7,0,15,0
10,238,01533,0,0,0,20,2,7,3,0,0,16,1,6,210243,17,10,0,22,0
10,238,01534,0,0,0,24,0,3,0,0,0,18,0,0,234432,18,3,0,24,0
10,239,01535,0,0,0,121,0,62,0,0,0,48,0,0,146561,48,62,0,121,0
10,239,01536,0,3,95,65,66,21,49,13,0,20,36,241,254753,56,70,13,131,3
10,239,01537,0,0,0,107,0,48,0,0,0,40,0,0,173487,40,48,0,107,0
10,239,01538,0,0,0,75,0,31,0,0,0,28,0,0,87703,28,31,0,75,0
10,239,01539,0,0,0,51,0,23,0,0,0,16,0,0,108130,16,23,0,51,0
10,239,01540,0,0,0,72,43,21,16,0,0,23,10,51,260154,33,37,0,115,0
10,239,01541,0,0,0,57,0,27,0,0,0,21,0,0,94485,21,27,0,57,0
10,240,01542,0,1,100,46,21,20,25,6,0,21,16,122,159686,37,45,6,67,1
10,240,01543,0,0,0,97,0,29,0,0,0,38,0,0,148941,38,29,0,97,0
10,240,01544,0,0,0,136,0,54,0,0,0,58,0,0,192187,58,54,0,136,0
10,240,01545,0,0,0,73,0,43,0,0,0,29,0,0,78185,29,43,0,73,0
10,240,01546,0,0,0,41,0,18,0,0,0,20,0,0,121818,20,18,0,41,0
11,241,01547,0,0,0,21,0,8,0,0,0,8,0,0,10031,8,8,0,21,0
11,241,01548,0,1,100,120,70,8,15,8,0,36,4,124,33637,40,23,8,190,1
11,242,01549,0,1,100,109,43,11,20,13,0,50,4,131,71672,54,31,13,152,1
11,242,01550,0,0,0,113,1,26,0,0,0,46,1,0,64679,47,26,0,114,0
11,243,01551,0,1,100,124,114,21,32,24,0,53,5,198,98863,58,53,24,238,1
11,243,01552,1,0,0,119,0,8,0,0,2,40,0,0,47955,40,8,2,119,1
11,244,01553,0,2,800,144,180,17,133,114,0,54,6,924,219386,60,150,114,324,2
11,244,01554,0,0,0,68,0,8,0,0,0,28,0,0,36392,28,8,0,68,0
11,244,01555,0,0,0,67,8,8,2,0,0,20,1,7,27721,21,10,0,75,0
12,245,01556,0,0,0,24,0,6,0,0,0,4,0,0,2854,4,6,0,24,0
12,245,01557,1,0,0,13,0,6,0,0,2,3,0,0,6172,3,6,2,13,1
12,245,01558,0,0,0,2,0,1,0,0,0,1,0,0,2694,1,1,0,2,0
12,245,01559,0,1,30,6,41,3,19,8,0,3,4,47,18501,7,22,8,47,1
12,245,01560,0,0,0,6,0,3,0,0,0,3,0,0,2615,3,3,0,6,0
12,245,01561,1,0,0,14,0,9,0,0,1,4,0,0,5480,4,9,1,14,1
12,245,01562,0,0,0,8,0,4,0,0,0,4,0,0,3782,4,4,0,8,0
12,245,01563,0,0,0,10,0,4,0,0,0,3,0,0,3655,3,4,0,10,0
12,245,01564,0,0,0,4,0,2,0,0,0,2,0,0,1185,2,2,0,4,0
12,245,01565,0,0,0,6,0,3,0,0,0,3,0,0,1559,3,3,0,6,0
12,246,01566,0,1,18,18,1,10,1,1,0,6,2,48,17708,8,11,1,19,1
12,246,01567,0,0,0,6,0,3,0,0,0,3,0,0,1208,3,3,0,6,0
12,246,01568,0,0,0,12,0,5,0,0,0,5,0,0,7193,5,5,0,12,0
12,246,01569,0,1,70,0,61,0,14,8,0,0,4,75,9792,4,14,8,61,1
12,246,01570,0,0,0,21,0,8,0,0,0,5,0,0,6575,5,8,0,21,0
12,246,01571,0,0,0,6,0,3,0,0,0,3,0,0,3057,3,3,0,6,0
12,246,01572,0,0,0,2,0,1,0,0,0,1,0,0,6593,1,1,0,2,0
12,246,01573,0,0,0,36,0,17,0,0,0,10,0,0,14504,10,17,0,36,0
12,246,01574,0,0,0,6,0,3,0,0,0,3,0,0,4981,3,3,0,6,0
12,246,01575,0,0,0,12,0,5,0,0,0,3,0,0,4765,3,5,0,12,0
12,246,01576,0,0,0,4,0,4,0,0,0,3,0,0,5035,3,4,0,4,0
12,246,01577,0,0,0,4,0,2,0,0,0,2,0,0,314,2,2,0,4,0
12,246,01578,0,0,0,6,0,3,0,0,0,3,0,0,752,3,3,0,6,0
12,247,01579,1,0,0,33,0,15,0,0,2,7,0,0,3734,7,15,2,33,1
12,247,01580,0,0,0,8,0,4,0,0,0,4,0,0,1393,4,4,0,8,0
12,247,01581,0,0,0,7,0,4,0,0,0,4,0,0,3527,4,4,0,7,0
12,247,01582,0,0,0,16,0,8,0,0,0,8,0,0,6093,8,8,0,16,0
12,247,01583,0,0,0,13,0,6,0,0,0,5,0,0,3562,5,6,0,13,0
12,247,01584,0,1,54,10,12,5,10,7,0,5,3,64,29089,8,15,7,22,1
12,247,01585,0,0,0,2,0,1,0,0,0,1,0,0,3051,1,1,0,2,0
12,247,01586,0,0,0,2,0,1,0,0,0,1,0,0,5405,1,1,0,2,0
12,247,01587,0,0,0,4,0,2,0,0,0,2,0,0,3683,2,2,0,4,0
12,247,01588,0,0,0,2,0,1,0,0,0,1,0,0,2306,1,1,0,2,0
12,247,01589,0,0,0,10,0,5,0,0,0,5,0,0,4015,5,5,0,10,0
12,247,01590,0,0,0,16,0,8,0,0,0,8,0,0,6713,8,8,0,16,0
12,247,01591,0,0,0,4,0,2,0,0,0,2,0,0,3991,2,2,0,4,0
12,248,01592,0,0,0,13,0,5,0,0,0,5,0,0,6603,5,5,0,13,0
12,248,01593,0,0,0,4,0,2,0,0,0,2,0,0,8381,2,2,0,4,0
12,248,01594,0,0,0,18,0,9,0,0,0,9,0,0,3589,9,9,0,18,0
12,248,01595,0,0,0,3,0,2,0,0,0,2,0,0,2217,2,2,0,3,0
12,248,01596,0,0,0,20,20,5,6,0,0,4,155420,6,65182,155424,11,0,40,0
12,248,01597,1,1,162,10,93,5,84,72,0,6,8,171,49061,14,89,72,103,2
12,248,01598,0,0,0,8,0,5,0,0,0,4,0,0,9451,4,5,0,8,0
12,248,01599,0,0,0,4,0,2,0,0,0,2,0,0,1638,2,2,0,4,0
12,248,01600,0,0,0,4,0,2,0,0,0,2,0,0,2709,2,2,0,4,0
12,248,01601,0,0,0,6,8,3,3,0,0,3,2,20,5456,5,6,0,14,0
12,248,01602,0,0,0,2,0,1,0,0,0,1,0,0,1589,1,1,0,2,0
12,248,01603,0,0,0,9,0,5,0,0,0,5,0,0,3986,5,5,0,9,0
12,248,01604,0,0,0,5,0,3,0,0,0,3,0,0,5949,3,3,0,5,0
12,248,01605,1,0,0,22,0,11,0,0,0,6,0,0,6698,6,11,0,22,1
12,248,01606,0,0,0,2,0,1,0,0,0,1,0,0,1618,1,1,0,2,0
12,249,01607,0,0,0,8,0,4,0,0,0,3,0,0,1183,3,4,0,8,0
12,249,01608,0,0,0,5,0,4,0,0,0,3,0,0,1425,3,4,0,5,0
12,249,01609,0,0,0,14,0,9,0,0,0,7,0,0,4823,7,9,0,14,0
12,249,01610,0,0,0,12,0,8,0,0,0,7,0,0,6866,7,8,0,12,0
12,249,01611,0,0,0,22,0,11,0,0,0,8,0,0,13006,8,11,0,22,0
12,249,01612,0,0,0,2,0,2,0,0,0,2,0,0,2246,2,2,0,2,0
12,249,01613,0,0,0,5,0,5,0,0,0,2,0,0,4986,2,5,0,5,0
12,249,01614,0,0,0,6,0,3,0,0,0,3,0,0,6490,3,3,0,6,0
12,249,01615,0,1,111,8,15,5,23,20,0,5,2,131,19426,7,28,20,23,1
12,249,01616,0,0,0,12,0,10,0,0,0,5,0,0,3784,5,10,0,12,0
12,249,01617,0,0,0,9,0,8,0,0,0,3,0,0,4834,3,8,0,9,0
12,249,01618,0,0,0,8,0,4,0,0,0,3,0,0,3795,3,4,0,8,0
12,249,01619,0,0,0,2,0,2,0,0,0,2,0,0,2507,2,2,0,2,0
12,249,01620,0,0,0,2,0,4,0,0,0,3,0,0,2475,3,4,0,2,0
12,249,01621,0,0,0,16,0,9,0,0,0,7,0,0,3118,7,9,0,16,0
12,250,01622,0,0,0,2,0,2,0,0,0,2,0,0,4846,2,2,0,2,0
12,250,01623,0,0,0,3,0,1,0,0,0,1,0,0,4111,1,1,0,3,0
12,250,01624,0,0,0,2,0,1,0,0,0,1,0,0,948,1,1,0,2,0
12,250,01625,0,0,0,8,0,4,0,0,0,4,0,0,2354,4,4,0,8,0
12,250,01626,0,0,0,5,0,2,0,0,0,2,0,0,2492,2,2,0,5,0
12,250,01627,0,0,0,5,0,2,0,0,0,1,0,0,5046,1,2,0,5,0
12,250,01628,0,0,0,4,0,2,0,0,0,2,0,0,1260,2,2,0,4,0
12,250,01629,0,0,0,4,0,2,0,0,0,2,0,0,6014,2,2,0,4,0
12,250,01630,0,0,0,6,0,3,0,0,0,3,0,0,3144,3,3,0,6,0
12,250,01631,0,0,0,5,0,3,0,0,0,2,0,0,3996,2,3,0,5,0
12,250,01632,0,0,0,7,0,3,0,0,0,2,0,0,4204,2,3,0,7,0
12,250,01633,0,0,0,2,0,1,0,0,0,1,0,0,2237,1,1,0,2,0
12,250,01634,0,1,79,14,51,7,20,18,0,6,6,85,34846,12,27,18,65,1
12,250,01635,0,0,0,11,0,6,0,0,0,5,0,0,5656,5,6,0,11,0
12,250,01636,0,1,30,2,75,1,11,8,0,1,3,30,12137,4,12,8,77,1
12,250,01637,0,0,0,10,0,5,0,0,0,5,0,0,2266,5,5,0,10,0
12,250,01638,0,0,0,6,0,3,0,0,0,2,0,0,1727,2,3,0,6,0
12,250,01639,0,0,0,4,0,2,0,0,0,2,0,0,1238,2,2,0,4,0
12,250,01640,0,0,0,6,0,3,0,0,0,3,0,0,5988,3,3,0,6,0
12,250,01641,0,0,0,4,0,2,0,0,0,2,0,0,2325,2,2,0,4,0
12,250,01642,0,0,0,5,0,2,0,0,0,2,0,0,3737,2,2,0,5,0
12,251,01643,0,0,0,6,0,3,0,0,0,3,0,0,5776,3,3,0,6,0
12,251,01644,6,0,0,13,0,6,0,0,0,12,0,0,4110,12,6,0,13,6
12,251,01645,1,0,0,14,0,7,0,0,1,6,0,0,3410,6,7,1,14,1
12,251,01646,0,0,0,4,0,2,0,0,0,2,0,0,1629,2,2,0,4,0
12,251,01647,0,0,0,10,0,5,0,0,0,5,0,0,2317,5,5,0,10,0
12,251,01648,0,0,0,6,0,3,0,0,0,3,0,0,1914,3,3,0,6,0
12,251,01649,0,0,0,1,0,1,0,0,0,1,0,0,884,1,1,0,1,0
12,251,01650,0,0,0,8,0,4,0,0,0,4,0,0,4989,4,4,0,8,0
12,251,01651,0,0,0,8,0,4,0,0,0,4,0,0,3048,4,4,0,8,0
12,251,01652,0,0,0,16,0,8,0,0,0,5,0,0,4734,5,8,0,16,0
12,251,01653,1,0,0,14,0,7,0,0,0,7,0,0,5679,7,7,0,14,1
12,251,01654,0,0,0,14,0,8,0,0,0,6,0,0,9715,6,8,0,14,0
12,251,01655,0,1,90,34,73,8,18,18,0,4,7,121,36311,11,26,18,107,1
12,251,01656,0,0,0,12,0,5,0,0,0,5,0,0,7015,5,5,0,12,0
12,251,01657,0,0,0,3,0,1,0,0,0,1,0,0,7459,1,1,0,3,0
12,252,01658,0,0,0,5,0,1,0,0,0,1,0,0,5205,1,1,0,5,0
12,252,01659,0,0,0,4,0,2,0,0,0,2,0,0,857,2,2,0,4,0
12,252,01660,0,0,0,2,0,1,0,0,0,1,0,0,533,1,1,0,2,0
12,252,01661,0,0,0,2,0,1,0,0,0,1,0,0,780,1,1,0,2,0
12,252,01662,0,0,0,4,0,2,0,0,0,2,0,0,847,2,2,0,4,0
12,252,01663,0,1,40,2,26,1,16,13,0,1,3,41,8567,4,17,13,28,1
12,252,01664,0,0,0,16,0,8,0,0,0,7,0,0,3228,7,8,0,16,0
12,252,01665,0,0,0,2,0,3,0,0,0,3,0,0,4435,3,3,0,2,0
12,252,01666,2,0,0,8,0,4,0,0,0,6,0,0,6260,6,4,0,8,2
12,252,01667,0,0,0,2,0,1,0,0,0,1,0,0,1360,1,1,0,2,0
12,252,01668,0,0,0,7,0,2,0,0,0,2,0,0,2944,2,2,0,7,0
12,253,01669,0,0,0,9,0,3,0,0,0,3,0,0,2973,3,3,0,9,0
12,253,01670,0,0,0,2,0,1,0,0,0,1,0,0,2693,1,1,0,2,0
12,253,01671,0,1,70,6,38,3,6,3,0,3,4,86,13521,7,9,3,44,1
12,253,01672,0,0,0,2,0,1,0,0,0,1,0,0,3800,1,1,0,2,0
12,253,01673,0,0,0,4,0,2,0,0,0,2,0,0,2627,2,2,0,4,0
12,253,01674,0,0,0,0,0,0,0,0,0,0,0,0,715,0,0,0,0,0
12,253,01675,0,0,0,0,0,0,0,0,0,0,0,0,757,0,0,0,0,0
12,253,01676,0,0,0,5,0,2,0,0,0,1,0,0,3561,1,2,0,5,0
12,253,01677,0,0,0,2,0,1,0,0,0,1,0,0,1128,1,1,0,2,0
12,253,01678,0,1,20,2,48,1,10,2,0,1,3,20,9767,4,11,2,50,1
12,253,01679,0,0,0,4,0,2,0,0,0,2,0,0,4438,2,2,0,4,0
12,253,01680,0,0,0,12,3,6,2,0,0,6,1,0,25786,7,8,0,15,0
12,253,01681,0,0,0,7,0,3,0,0,0,2,0,0,14516,2,3,0,7,0
12,253,01682,0,0,0,15,0,6,0,0,0,5,0,0,32007,5,6,0,15,0
12,253,01683,0,0,0,9,0,4,0,0,0,3,0,0,29045,3,4,0,9,0
12,254,01684,0,0,0,6,14,3,1,0,0,3,2,0,11398,5,4,0,20,0
12,254,01685,0,0,0,7,0,3,0,0,0,3,0,0,3082,3,3,0,7,0
12,254,01686,0,1,55,24,107,11,13,10,0,10,2,56,26249,12,24,10,131,1
12,254,01687,0,0,0,8,0,3,0,0,0,2,0,0,5074,2,3,0,8,0
12,254,01688,1,0,0,18,0,6,0,0,2,5,0,0,7096,5,6,2,18,1
12,254,01689,0,0,0,6,0,3,0,0,0,3,0,0,4946,3,3,0,6,0
12,254,01690,0,1,16,8,33,4,3,3,0,4,1,16,16897,5,7,3,41,1
12,254,01691,0,0,0,2,0,1,0,0,0,1,0,0,4934,1,1,0,2,0
12,254,01692,0,0,0,10,0,5,0,0,0,4,0,0,11805,4,5,0,10,0
12,254,01693,0,0,0,6,0,3,0,0,0,3,0,0,11216,3,3,0,6,0
12,254,01694,0,0,0,13,0,6,0,0,0,5,0,0,9113,5,6,0,13,0
12,255,01695,0,1,80,16,143,8,19,14,0,6,2,100,21285,8,27,14,159,1
12,255,01696,0,0,0,22,0,17,0,0,0,5,0,0,19112,5,17,0,22,0
12,255,01697,0,0,0,18,0,7,0,0,0,5,0,0,8338,5,7,0,18,0
12,255,01698,0,0,0,19,0,13,0,0,0,5,0,0,9341,5,13,0,19,0
12,255,01699,0,0,0,20,0,9,0,0,0,7,0,0,6979,7,9,0,20,0
12,255,01700,0,0,0,10,0,5,0,0,0,5,0,0,5876,5,5,0,10,0
12,255,01701,0,0,0,4,0,3,0,0,0,1,0,0,2885,1,3,0,4,0
12,255,01702,0,0,0,13,0,8,0,0,0,4,0,0,5086,4,8,0,13,0
12,256,01703,0,0,0,12,0,6,0,0,0,6,0,0,9497,6,6,0,12,0
12,256,01704,0,0,0,6,0,3,0,0,0,3,0,0,6650,3,3,0,6,0
12,256,01705,0,0,0,8,0,4,0,0,0,4,0,0,10687,4,4,0,8,0
12,256,01706,0,0,0,4,0,2,0,0,0,2,0,0,6392,2,2,0,4,0
12,256,01707,0,0,0,2,0,1,0,0,0,1,0,0,2149,1,1,0,2,0
12,256,01708,0,1,12,6,4,3,1,1,0,3,1,12,6821,4,4,1,10,1
12,256,01709,0,0,0,8,0,4,0,0,0,4,0,0,5040,4,4,0,8,0
12,256,01710,0,0,0,4,0,2,0,0,0,2,0,0,4886,2,2,0,4,0
12,256,01711,0,0,0,2,0,1,0,0,0,1,0,0,3169,1,1,0,2,0
12,256,01712,0,0,0,3,0,1,0,0,0,1,0,0,2701,1,1,0,3,0
12,256,01713,0,0,0,6,0,3,0,0,0,3,0,0,9014,3,3,0,6,0
12,256,01714,0,0,0,8,0,4,0,0,0,4,0,0,5283,4,4,0,8,0
12,256,01715,0,0,0,2,0,1,0,0,0,1,0,0,6672,1,1,0,2,0
12,256,01716,0,0,0,6,0,3,0,0,0,3,0,0,8945,3,3,0,6,0
12,257,01717,0,0,0,0,0,0,0,0,0,0,0,0,259,0,0,0,0,0
12,257,01718,0,1,50,2,37,1,3,2,0,1,3,51,3854,4,4,2,39,1
12,257,01719,0,0,0,5,0,1,0,0,0,1,0,0,860,1,1,0,5,0
12,257,01720,0,0,0,2,0,1,0,0,0,1,0,0,283,1,1,0,2,0
12,257,01721,0,0,0,0,0,0,0,0,0,0,0,0,756,0,0,0,0,0
12,258,01722,0,0,0,15,0,4,0,0,0,3,0,0,1047,3,4,0,15,0
12,258,01723,0,0,0,2,0,1,0,0,0,1,0,0,346,1,1,0,2,0
12,258,01724,3,1,50,30,17,14,12,10,4,12,3,61,35370,15,26,14,47,4
12,258,01725,0,0,0,10,0,6,0,0,0,6,0,0,4384,6,6,0,10,0
12,258,01726,0,0,0,16,0,8,0,0,0,7,0,0,5319,7,8,0,16,0
12,258,01727,0,0,0,2,0,1,0,0,0,1,0,0,5479,1,1,0,2,0
12,259,01728,0,0,0,6,0,3,0,0,0,3,0,0,5529,3,3,0,6,0
12,259,01729,0,1,88,19,87,9,12,10,0,9,4,89,35121,13,21,10,106,1
12,259,01730,0,0,0,21,0,7,0,0,0,6,0,0,8535,6,7,0,21,0
12,259,01731,0,0,0,11,0,6,0,0,0,4,0,0,21835,4,6,0,11,0
12,259,01732,0,1,40,3,51,1,8,7,0,1,3,52,26815,4,9,7,54,1
12,259,01733,0,0,0,13,0,7,0,0,0,7,0,0,8320,7,7,0,13,0
12,259,01734,0,0,0,11,0,8,0,0,0,6,0,0,10436,6,8,0,11,0
12,259,01735,0,0,0,31,0,15,0,0,0,11,0,0,28219,11,15,0,31,0
12,260,01736,0,0,0,2,0,2,0,0,0,2,0,0,4777,2,2,0,2,0
12,260,01737,0,0,0,8,0,4,0,0,0,4,0,0,2521,4,4,0,8,0
12,260,01738,0,0,0,4,0,2,0,0,0,2,0,0,1339,2,2,0,4,0
12,260,01739,0,0,0,2,0,1,0,0,0,1,0,0,826,1,1,0,2,0
12,260,01740,0,0,0,4,0,2,0,0,0,2,0,0,1164,2,2,0,4,0
12,260,01741,0,0,0,2,0,1,0,0,0,1,0,0,1346,1,1,0,2,0
12,260,01742,0,0,0,4,0,2,0,0,0,2,0,0,959,2,2,0,4,0
12,260,01743,0,1,16,14,16,7,2,1,0,7,1,16,4374,8,9,1,30,1
13,261,01744,0,0,0,1,4,0,0,0,0,1,1,1,11023,2,0,0,5,0
13,261,01745,0,0,0,20,0,1,0,0,0,5,0,0,22352,5,1,0,20,0
13,261,01746,0,0,0,7,0,0,0,0,0,3,0,0,8435,3,0,0,7,0
13,261,01747,0,0,0,11,0,0,0,0,0,5,0,0,6138,5,0,0,11,0
13,261,01748,0,1,50,18,29,1,10,8,0,9,4,55,47977,13,11,8,47,1
13,261,01749,0,0,0,27,0,0,0,0,0,4,0,0,12738,4,0,0,27,0
13,261,01750,0,0,0,10,0,2,0,0,0,4,0,0,14257,4,2,0,10,0
13,261,01751,0,0,0,22,0,1,0,0,0,5,0,0,20311,5,1,0,22,0
13,261,01752,0,0,0,13,0,1,0,0,0,2,0,0,12539,2,1,0,13,0
13,261,01753,0,0,0,24,0,0,0,0,0,8,0,0,18656,8,0,0,24,0
13,261,01754,0,0,0,16,0,0,0,0,0,7,0,0,20307,7,0,0,16,0
13,261,01755,0,0,0,17,0,0,0,0,0,7,0,0,15377,7,0,0,17,0
13,261,01756,0,0,0,33,0,3,0,0,0,3,0,0,16925,3,3,0,33,0
13,261,01757,0,0,0,2,0,0,0,0,0,2,0,0,23225,2,0,0,2,0
13,262,01758,0,0,0,24,0,4,0,0,0,7,0,0,8579,7,4,0,24,0
13,262,01759,0,0,0,26,0,2,0,0,0,8,0,0,11947,8,2,0,26,0
13,262,01760,0,0,0,8,0,1,0,0,0,1,0,0,23377,1,1,0,8,0
13,262,01761,0,0,0,7,6,0,0,0,0,3,1,1,17372,4,0,0,13,0
13,262,01762,0,0,0,32,0,10,0,0,0,8,0,0,17832,8,10,0,32,0
13,262,01763,0,0,0,34,0,3,0,0,0,6,0,0,12679,6,3,0,34,0
13,262,01764,0,0,0,48,0,4,0,0,0,6,0,0,12921,6,4,0,48,0
13,262,01765,0,0,0,12,0,2,0,0,0,4,0,0,6044,4,2,0,12,0
13,262,01766,0,2,230,83,51,4,20,15,0,21,7,266,83797,28,24,15,134,2
13,263,01767,0,0,0,29,0,1,0,0,0,2,0,0,3931,2,1,0,29,0
13,263,01768,0,0,0,41,0,4,0,0,0,6,0,0,6612,6,4,0,41,0
13,263,01769,0,0,0,35,0,2,0,0,0,12,0,0,13957,12,2,0,35,0
13,263,01770,0,0,0,24,0,3,0,0,0,4,0,0,7598,4,3,0,24,0
13,263,01771,0,0,0,36,0,4,0,0,0,3,0,0,18341,3,4,0,36,0
13,263,01772,0,1,40,31,21,0,8,6,0,8,3,42,35977,11,8,6,52,1
13,263,01773,0,0,0,53,0,3,0,0,0,7,0,0,8740,7,3,0,53,0
13,263,01774,0,0,0,10,0,0,0,0,0,1,0,0,3876,1,0,0,10,0
13,263,01775,0,0,0,24,0,4,0,0,0,5,0,0,8899,5,4,0,24,0
13,263,01776,0,0,0,17,0,2,0,0,0,10,0,0,7967,10,2,0,17,0
13,263,01777,0,0,0,15,8,0,1,0,0,4,1,1,15103,5,1,0,23,0
13,263,01778,0,0,0,4,0,0,0,0,0,2,0,0,5163,2,0,0,4,0
13,263,01779,0,0,0,8,0,0,0,0,0,3,0,0,4540,3,0,0,8,0
13,264,01780,0,0,0,14,0,0,0,0,0,4,0,0,5384,4,0,0,14,0
13,264,01781,0,0,0,28,0,2,0,0,0,5,0,0,16194,5,2,0,28,0
13,264,01782,0,0,0,39,0,3,0,0,0,7,0,0,17124,7,3,0,39,0
13,264,01783,0,0,0,15,0,1,0,0,0,2,0,0,2697,2,1,0,15,0
13,264,01784,0,0,0,27,0,3,0,0,0,7,0,0,13028,7,3,0,27,0
13,264,01785,0,0,0,33,0,3,0,0,0,6,0,0,7155,6,3,0,33,0
13,264,01786,0,0,0,18,0,1,0,0,0,5,0,0,6338,5,1,0,18,0
13,264,01787,0,0,0,7,0,0,0,0,0,3,0,0,8627,3,0,0,7,0
13,264,01788,0,0,0,57,0,5,0,0,0,5,0,0,8680,5,5,0,57,0
13,264,01789,0,1,60,45,28,3,11,8,0,10,4,73,58186,14,14,8,73,1
13,264,01790,0,0,0,4,0,1,0,0,0,4,0,0,12856,4,1,0,4,0
13,264,01791,0,0,0,45,0,4,0,0,0,4,0,0,10043,4,4,0,45,0
13,265,01792,0,0,0,24,0,2,0,0,0,7,0,0,11876,7,2,0,24,0
13,265,01793,0,0,0,8,0,0,0,0,0,3,0,0,9105,3,0,0,8,0
13,265,01794,0,0,0,25,0,2,0,0,0,9,0,0,12519,9,2,0,25,0
13,265,01795,0,0,0,4,0,0,0,0,0,1,0,0,8699,1,0,0,4,0
13,265,01796,0,7,550,23,148,0,66,46,0,6,35,652,169613,41,66,46,171,7
13,265,01797,0,2,610,44,192,1,62,60,0,17,5,626,125400,22,63,60,236,2
13,265,01798,0,0,0,33,0,6,0,0,0,8,0,0,17362,8,6,0,33,0
13,265,01799,0,0,0,11,0,1,0,0,0,2,0,0,24149,2,1,0,11,0
13,266,01800,0,0,0,28,0,2,0,0,0,8,0,0,11366,8,2,0,28,0
13,266,01801,0,1,60,32,22,1,12,10,0,11,4,63,27407,15,13,10,54,1
13,266,01802,0,0,0,11,0,1,0,0,0,4,0,0,4007,4,1,0,11,0
13,266,01803,0,0,0,12,0,5,0,0,0,3,0,0,13890,3,5,0,12,0
13,266,01804,0,0,0,11,0,1,0,0,0,3,0,0,5117,3,1,0,11,0
13,266,01805,0,0,0,6,0,0,0,0,0,2,0,0,3611,2,0,0,6,0
13,266,01806,0,0,0,18,0,4,0,0,0,7,0,0,14836,7,4,0,18,0
13,266,01807,0,0,0,25,0,2,0,0,0,6,0,0,16881,6,2,0,25,0
13,266,01808,0,0,0,20,0,1,0,0,0,4,0,0,9241,4,1,0,20,0
13,266,01809,0,0,0,32,4,2,0,0,0,5,1,1,31229,6,2,0,36,0
13,266,01810,0,0,0,14,0,1,0,0,0,1,0,0,5244,1,1,0,14,0
13,266,01811,0,0,0,8,0,2,0,0,0,1,0,0,3810,1,2,0,8,0
13,266,01812,0,0,0,10,0,2,0,0,0,3,0,0,10274,3,2,0,10,0
13,266,01813,0,0,0,9,0,0,0,0,0,2,0,0,6505,2,0,0,9,0
13,267,01814,0,0,0,17,0,1,0,0,0,4,0,0,14182,4,1,0,17,0
13,267,01815,0,0,0,31,0,6,0,0,0,6,0,0,11111,6,6,0,31,0
13,267,01816,0,0,0,22,0,6,0,0,0,5,0,0,17306,5,6,0,22,0
13,267,01817,0,1,80,2,47,1,17,15,0,1,4,92,47865,5,18,15,49,1
13,267,01818,0,0,0,2,0,0,0,0,0,1,0,0,6111,1,0,0,2,0
13,267,01819,0,0,0,12,0,0,0,0,0,5,0,0,6629,5,0,0,12,0
13,267,01820,0,0,0,15,0,1,0,0,0,3,0,0,10707,3,1,0,15,0
13,267,01821,0,0,0,24,0,3,0,0,0,2,0,0,19507,2,3,0,24,0
13,267,01822,0,0,0,9,0,0,0,0,0,2,0,0,3866,2,0,0,9,0
13,267,01823,0,0,0,10,0,0,0,0,0,2,0,0,6291,2,0,0,10,0
13,267,01824,0,0,0,10,0,0,0,0,0,2,0,0,11036,2,0,0,10,0
13,267,01825,0,0,0,53,0,1,0,0,0,6,0,0,12714,6,1,0,53,0
13,267,01826,0,0,0,0,0,0,0,0,0,0,0,0,2132,0,0,0,0,0
13,267,01827,0,0,0,18,0,1,0,0,0,3,0,0,5438,3,1,0,18,0
13,267,01828,0,0,0,4,0,0,0,0,0,1,0,0,2998,1,0,0,4,0
13,267,01829,0,0,0,40,0,1,0,0,0,5,0,0,18600,5,1,0,40,0
13,268,01830,0,0,0,33,0,1,0,0,0,1,0,0,5336,1,1,0,33,0
13,268,01831,0,0,0,0,0,0,0,0,0,0,0,0,3518,0,0,0,0,0
13,268,01832,0,0,0,18,0,1,0,0,0,4,0,0,9820,4,1,0,18,0
13,268,01833,0,1,25,10,14,1,8,6,0,1,4,27,23184,5,9,6,24,1
13,268,01834,0,0,0,7,0,0,0,0,0,2,0,0,8575,2,0,0,7,0
13,269,01835,0,0,0,3,0,1,0,0,0,1,0,0,9951,1,1,0,3,0
13,269,01836,0,0,0,9,0,5,0,0,0,3,0,0,9075,3,5,0,9,0
13,269,01837,0,1,30,11,17,0,9,7,0,3,4,32,21916,7,9,7,28,1
13,269,01838,0,0,0,2,0,0,0,0,0,1,0,0,5171,1,0,0,2,0
13,269,01839,0,0,0,3,0,0,0,0,0,1,0,0,4035,1,0,0,3,0
13,269,01840,0,0,0,2,0,0,0,0,0,1,0,0,4722,1,0,0,2,0
13,269,01841,0,0,0,5,0,1,0,0,0,2,0,0,14425,2,1,0,5,0
13,269,01842,0,0,0,0,0,0,0,0,0,0,0,0,4646,0,0,0,0,0
13,270,01843,0,0,0,22,9,4,0,0,0,5,1,1,51314,6,4,0,31,0
13,270,01844,0,0,0,0,0,0,0,0,0,0,0,0,5494,0,0,0,0,0
13,270,01845,0,0,0,60,0,12,0,0,0,10,0,0,19659,10,12,0,60,0
13,270,01846,0,0,0,12,0,1,0,0,0,4,0,0,6695,4,1,0,12,0
13,270,01847,0,0,0,24,0,1,0,0,0,3,0,0,16467,3,1,0,24,0
13,270,01848,0,0,0,18,0,5,0,0,0,8,0,0,34056,8,5,0,18,0
13,270,01849,0,7,360,5,198,0,54,40,0,1,19,425,116870,20,54,40,203,7
13,270,01850,0,0,0,36,0,3,0,0,0,6,0,0,17369,6,3,0,36,0
13,271,01851,0,0,0,52,0,2,0,0,0,7,0,0,10105,7,2,0,52,0
13,271,01852,0,2,0,22,8,1,0,0,0,4,3,1,28391,7,1,0,30,2
13,271,01853,0,0,0,31,0,3,0,0,0,7,0,0,13901,7,3,0,31,0
13,271,01854,0,0,0,13,0,0,0,0,0,3,0,0,3012,3,0,0,13,0
13,271,01855,0,0,0,5,0,0,0,0,0,1,0,0,5200,1,0,0,5,0
13,271,01856,0,0,0,60,0,5,0,0,0,5,0,0,25864,5,5,0,60,0
13,271,01857,0,1,50,5,22,0,7,5,0,1,4,54,8697,5,7,5,27,1
14,272,01858,1,0,0,73,0,47,0,0,1,35,0,0,163380,35,47,1,73,1
14,272,01859,0,0,0,21,0,14,0,0,0,10,0,0,53901,10,14,0,21,0
14,272,01860,0,0,0,17,0,17,0,0,0,15,0,0,68123,15,17,0,17,0
14,272,01861,0,1,30,19,61,14,15,9,0,11,1,56,71744,12,29,9,80,1
14,272,01862,0,0,0,24,0,14,0,0,0,13,0,0,58424,13,14,0,24,0
14,272,01863,0,0,0,49,0,24,0,0,0,23,0,0,63300,23,24,0,49,0
14,273,01864,0,0,0,24,0,10,0,0,0,11,0,0,27742,11,10,0,24,0
14,273,01865,0,0,0,6,0,3,0,0,0,3,0,0,28056,3,3,0,6,0
14,273,01866,0,1,50,21,23,9,9,6,0,9,1237,64,48182,1246,18,6,44,1
14,273,01867,0,0,0,79,0,32,0,0,0,11,0,0,36581,11,32,0,79,0
14,274,01868,0,0,0,61,0,36,0,0,0,15,0,0,28712,15,36,0,61,0
14,274,01869,0,0,0,59,0,34,0,0,0,19,0,0,18442,19,34,0,59,0
14,274,01870,0,0,0,42,0,21,0,0,0,16,0,0,30525,16,21,0,42,0
14,274,01871,0,1,60,89,39,43,13,7,0,33,1051,79,173518,1084,56,7,128,1
14,274,01872,1,0,0,56,0,29,0,0,1,15,0,0,22109,15,29,1,56,1
14,275,01873,0,0,0,20,6,12,8,0,0,7,2,34,61882,9,20,0,26,0
14,275,01874,0,1,50,19,35,12,21,19,0,7,3,62,62778,10,33,19,54,1
14,275,01875,0,0,0,42,43,29,11,0,0,11,2313,46,112739,2324,40,0,85,0
14,276,01876,0,1,30,22,18,18,8,4,0,11,3,43,87377,14,26,4,40,1
14,276,01877,0,2,80,72,49,40,18,9,0,22,7,109,199310,29,58,9,121,2
14,276,01878,0,0,0,77,9,30,3,0,0,21,3,11,135477,24,33,0,86,0
14,277,01879,0,0,0,49,5,19,2,0,0,18,2,4,84840,20,21,0,54,0
14,277,01880,0,0,0,42,7,17,3,0,0,13,2,8,70665,15,20,0,49,0
14,277,01881,0,1,500,6,861,2,337,230,0,2,21845,1035,221422,21847,339,230,867,1
14,277,01882,0,0,0,45,86,19,26,0,0,19,7,55,141049,26,45,0,131,0
14,278,01883,0,0,0,11,10,20,3,0,0,10,0,8,43720,10,23,0,21,0
14,278,01884,0,0,0,47,2,16,1,0,0,21,1,2,86121,22,17,0,49,0
14,278,01885,0,1,400,96,545,28,184,112,0,22,11273,619,244089,11295,212,112,641,1
14,278,01886,0,1,7,26,20,11,4,2,0,16,2,15,82002,18,15,2,46,1
14,279,01887,0,0,0,18,0,7,0,0,0,8,0,0,31004,8,7,0,18,0
14,279,01888,0,1,50,36,13,20,6,4,0,18,2,60,107378,20,26,4,49,1
14,279,01889,0,0,0,31,0,10,0,0,0,11,0,0,16684,11,10,0,31,0
14,279,01890,0,0,0,24,0,11,0,0,0,8,0,0,16539,8,11,0,24,0
14,279,01891,0,0,0,17,0,7,0,0,0,5,0,0,12360,5,7,0,17,0
14,280,01892,0,0,0,11,0,8,0,0,0,4,0,0,19756,4,8,0,11,0
14,280,01893,0,1,50,11,10,8,3,3,0,3,3,60,39198,6,11,3,21,1
14,280,01894,0,0,0,20,0,14,0,0,0,7,0,0,32074,7,14,0,20,0
14,280,01895,0,0,0,22,0,10,0,0,0,5,0,0,52717,5,10,0,22,0
15,281,01896,0,8,4,14,12,7,6,6,0,21,11,11,47188,32,13,6,26,8
15,281,01897,0,0,0,25,0,4,0,0,0,6,0,0,21309,6,4,0,25,0
15,281,01898,0,0,0,62,0,4,0,0,0,17,6,0,17867,23,4,0,62,0
15,282,01899,0,1,1,8,14,2,1,1,0,8,1,1,19840,9,3,1,22,1
15,282,01900,0,3,29,15,28,0,16,15,0,10,6,29,58487,16,16,15,43,3
15,282,01901,0,0,0,10,0,3,0,0,0,7,0,0,5628,7,3,0,10,0
15,283,01901,0,1,3,0,10,0,48,11,0,4,55,70,311731,59,48,11,10,1
15,283,01902,0,0,0,18,0,10,1,0,0,27,1,10,26048,28,11,0,18,0
15,283,01903,2,0,0,18,0,2,0,0,0,28,0,0,13303,28,2,0,18,2
15,283,01904,1,0,0,56,0,8,0,0,0,38,0,0,17090,38,8,0,56,1
15,283,01905,1,1,0,23,26,12,4,1,0,18,5,11,32041,23,16,1,49,2
15,284,01906,1,0,0,23,0,7,0,0,0,20,0,0,18714,20,7,0,23,1
15,284,01907,0,1,10,11,0,1,4,3,0,28,5,18,35891,33,5,3,11,1
15,284,01908,0,1,6,13,52,1,11,9,0,7,126,6,43040,133,12,9,65,1
15,284,01909,0,0,0,24,0,1,0,0,0,27,0,0,22137,27,1,0,24,0
15,284,01911,0,0,0,12,0,1,1,0,0,4,1,33,5907,5,2,0,12,0
15,285,01905,0,0,0,2,0,0,0,0,0,2,0,0,5798,2,0,0,2,0
15,285,01910,0,2,8,57,18,2,14,12,0,17,7,8,44242,24,16,12,75,2
15,285,01911,2,0,0,7,0,3,1,0,0,24,1,10,14870,25,4,0,7,2
15,286,01912,0,0,0,16,0,6,0,0,0,15,0,0,18813,15,6,0,16,0
15,286,01913,1,0,0,20,0,3,0,0,0,13,2,10,38983,15,3,0,20,1
15,286,01914,0,1,1,29,0,5,0,0,0,31,38351,2,77482,38382,5,0,29,1
15,286,01915,0,0,0,56,2,7,2,0,0,16,2,2,26093,18,9,0,58,0
15,287,01916,0,0,0,12,0,1,0,0,0,17,0,0,45307,17,1,0,12,0
15,287,01917,0,1,1,23,19,5,6,1,0,39,6,6,38722,45,11,1,42,1
15,287,01918,0,0,0,3,0,0,0,0,0,7,0,0,17126,7,0,0,3,0
15,287,01919,0,0,0,30,0,3,0,0,0,21,0,0,16722,21,3,0,30,0
15,288,01920,0,0,0,57,0,7,0,0,0,23,0,0,21043,23,7,0,57,0
15,288,01921,0,1,64,18,50,1,11,11,0,14,73,64,35531,87,12,11,68,1
16,289,01922,2,2,10,62,55,67,19,9,8,38,5,10,163639,43,86,17,117,4
16,289,01923,0,0,0,20,0,14,0,0,0,8,0,0,35628,8,14,0,20,0
16,289,01924,1,0,0,21,0,19,0,0,1,12,0,0,35534,12,19,1,21,1
16,289,01925,0,0,0,17,0,18,0,0,0,10,0,0,64998,10,18,0,17,0
16,289,01926,4,0,0,50,0,48,0,0,4,42,0,0,43459,42,48,4,50,4
16,289,01927,0,0,0,8,0,8,0,0,0,22,0,0,46579,22,8,0,8,0
16,289,01928,1,0,0,29,0,35,0,0,1,14,0,0,68269,14,35,1,29,1
16,289,01929,0,0,0,9,0,14,0,0,0,30,0,0,29167,30,14,0,9,0
16,289,01930,2,0,0,44,0,48,0,0,8,20,0,0,44670,20,48,8,44,2
16,289,01931,2,1,0,76,25,63,10,6,12,28,4,0,142269,32,73,18,101,3
16,289,01932,1,1,0,26,32,18,18,1,2,17,7,0,118886,24,36,3,58,2
16,289,01933,2,0,0,26,0,21,0,0,3,12,0,0,45682,12,21,3,26,2
16,289,01934,2,0,0,49,2,36,1,0,2,34,1,0,166253,35,37,2,51,2
16,289,01935,1,0,0,23,0,22,0,0,3,17,0,0,51707,17,22,3,23,1
16,289,01936,0,0,0,15,0,20,0,0,0,19,0,0,121474,19,20,0,15,0
16,289,01937,3,0,0,64,0,34,0,0,5,23,0,0,62489,23,34,5,64,3
16,289,99999,0,6,981,0,484,0,439,364,0,0,33,1131,485036,33,439,364,484,6
16,290,01938,3,0,0,38,0,13,0,0,6,12,0,0,40912,12,13,6,38,3
16,290,01939,1,0,0,31,0,18,0,0,1,10,0,0,56572,10,18,1,31,1
16,290,01940,3,0,0,32,0,27,0,0,5,31,0,0,38635,31,27,5,32,3
16,290,01941,0,0,0,47,4,46,1,0,0,31,2,0,128877,33,47,0,51,0
16,290,01942,1,0,0,57,0,50,0,0,2,29,0,0,75295,29,50,2,57,1
16,290,01943,4,0,0,85,0,77,0,0,7,60,0,0,94211,60,77,7,85,4
16,290,01944,1,0,0,55,0,46,0,0,1,40,0,0,52736,40,46,1,55,1
16,290,01945,2,0,0,124,0,112,0,0,3,97,0,0,125457,97,112,3,124,2
16,290,01946,2,0,0,39,4,31,0,0,3,21,1,0,45350,22,31,3,43,2
16,290,01947,3,0,0,56,0,42,0,0,7,28,0,0,47946,28,42,7,56,3
16,290,01948,2,0,0,71,0,61,0,0,4,33,0,0,87355,33,61,4,71,2
16,290,99999,0,5,365,0,145,0,72,51,0,0,13,365,82655,13,72,51,145,5
16,291,01949,2,0,0,114,2,101,2,0,2,54,1,0,119282,55,103,2,116,2
16,291,01950,2,0,0,179,9,109,5,0,7,40,2,0,84194,42,114,7,188,2
16,291,01951,1,0,0,86,0,67,0,0,6,39,0,0,54618,39,67,6,86,1
16,291,01952,1,0,0,40,0,24,0,0,2,13,0,0,33579,13,24,2,40,1
16,291,01953,0,0,0,68,0,38,0,0,0,14,0,0,59400,14,38,0,68,0
16,291,99999,0,1,70,0,119,0,26,11,0,0,47,70,27157,47,26,11,119,1
16,292,01954,0,0,0,55,0,42,0,0,0,27,0,0,108711,27,42,0,55,0
16,292,01955,3,0,0,38,0,29,0,0,5,24,0,0,123298,24,29,5,38,3
16,292,01956,0,2,25,48,17,28,13,4,0,21,5,25,111565,26,41,4,65,2
16,292,01957,0,0,0,21,0,19,0,0,0,13,0,0,27635,13,19,0,21,0
16,292,01958,0,0,0,39,0,11,0,0,0,7,0,0,43146,7,11,0,39,0
16,292,01959,1,0,0,89,11,30,3,0,2,23,1,0,89190,24,33,2,100,1
16,292,01960,3,1,15,44,26,48,8,7,9,32,6,15,102037,38,56,16,70,4
16,292,01961,0,0,0,30,0,7,0,0,0,8,0,0,12311,8,7,0,30,0
16,292,99999,0,3,192,0,105,0,49,31,0,0,13,192,76054,13,49,31,105,3
17,293,01962,0,0,0,48,0,22,0,0,0,25,0,0,175049,25,22,0,48,0
17,293,01963,0,0,0,16,0,6,0,0,0,11,0,0,41564,11,6,0,16,0
17,293,01964,0,0,0,17,0,8,0,0,0,11,0,0,58312,11,8,0,17,0
17,293,01965,0,1,200,32,98,17,59,40,0,17,10,266,133585,27,76,40,130,1
17,293,01966,0,0,0,23,0,13,0,0,0,11,0,0,72061,11,13,0,23,0
17,293,01967,0,0,0,33,0,20,0,0,0,15,0,0,74516,15,20,0,33,0
17,293,01968,0,0,0,17,0,9,0,0,0,8,0,0,33108,8,9,0,17,0
17,293,01969,0,0,0,24,0,11,0,0,0,53,0,0,53742,53,11,0,24,0
17,294,01970,0,0,0,47,0,17,0,0,0,39,0,0,104144,39,17,0,47,0
17,294,01971,0,0,0,24,0,7,0,0,0,14,0,0,52387,14,7,0,24,0
17,294,01972,0,0,0,24,0,12,0,0,0,15,0,0,51414,15,12,0,24,0
17,294,01973,0,0,0,40,0,24,0,0,0,19,0,0,52961,19,24,0,40,0
17,294,01974,0,1,100,13,41,8,23,14,0,5,3,146,55901,8,31,14,54,1
17,295,01975,0,0,0,17,0,8,0,0,0,8,0,0,38699,8,8,0,17,0
17,295,01976,0,0,0,5,0,0,0,0,0,12,0,0,27433,12,0,0,5,0
17,295,01977,0,1,100,20,36,11,17,10,0,9,3,136,50574,12,28,10,56,1
17,295,01978,0,0,0,14,0,9,0,0,0,6,0,0,22813,6,9,0,14,0
17,296,01979,0,0,0,35,0,18,0,0,0,19,0,0,73716,19,18,0,35,0
17,296,01980,0,1,100,25,51,7,21,9,0,19,4,136,81277,23,28,9,76,1
17,296,01981,0,0,0,24,0,15,0,0,0,13,0,0,48941,13,15,0,24,0
17,296,01982,0,1,100,48,54,30,17,9,0,19,4,135,82306,23,47,9,102,1
17,296,01983,0,0,0,26,0,14,0,0,0,12,0,0,40972,12,14,0,26,0
17,296,01984,0,0,0,25,0,13,0,0,0,18,0,0,54170,18,13,0,25,0
17,297,01985,0,1,100,18,61,7,20,11,0,16,3,136,86894,19,27,11,79,1
17,297,01986,0,0,0,12,0,8,0,0,0,8,0,0,30630,8,8,0,12,0
17,297,01987,0,0,0,53,5,28,3,0,0,24,1,0,140649,25,31,0,58,0
17,298,01988,0,0,0,28,0,12,0,0,0,14,0,0,71378,14,12,0,28,0
17,298,01989,0,1,600,15,222,9,144,57,0,9,29,951,442950,38,153,57,237,1
17,298,01990,0,0,0,20,0,11,0,0,0,19,0,0,67205,19,11,0,20,0
17,298,01991,0,0,0,21,0,12,0,0,0,13,0,0,44554,13,12,0,21,0
17,298,01992,0,0,0,20,0,7,0,0,0,12,0,0,33279,12,7,0,20,0
17,298,01993,0,0,0,23,0,17,0,0,0,12,0,0,53816,12,17,0,23,0
17,298,01994,0,0,0,45,0,27,0,0,0,20,1,0,53662,21,27,0,45,0
17,298,01995,0,0,0,18,0,14,0,0,0,10,0,0,57608,10,14,0,18,0
17,299,01996,0,1,100,49,61,20,34,19,0,23,7,136,137851,30,54,19,110,1
17,299,01997,0,0,0,45,0,25,0,0,0,20,0,0,90370,20,25,0,45,0
17,299,01998,0,0,0,33,0,19,0,0,0,14,0,0,43648,14,19,0,33,0
17,299,01999,0,0,0,61,0,28,0,0,0,28,0,0,85698,28,28,0,61,0
17,299,02000,0,0,0,24,0,3,0,0,0,19,0,0,36989,19,3,0,24,0
18,300,02001,1,1,10,164,64,101,21,4,2,54,7,62,270906,61,122,6,228,2
18,300,02002,0,0,0,68,0,39,0,0,0,26,0,0,78061,26,39,0,68,0
18,300,02003,0,0,0,76,0,48,0,0,0,34,0,0,144393,34,48,0,76,0
18,300,02004,0,2,175,125,91,73,40,9,0,55,10,208,253062,65,113,9,216,2
18,300,02005,0,0,0,24,0,21,0,0,0,14,0,0,50770,14,21,0,24,0
18,300,02007,0,0,0,12,0,4,0,0,0,1,0,0,26613,1,4,0,12,0
18,300,02008,0,0,0,0,0,0,0,0,0,1,0,0,33713,1,0,0,0,0
18,300,02009,0,0,0,1,0,1,0,0,0,1,0,0,8736,1,1,0,1,0
18,300,02010,0,0,0,6,0,3,0,0,0,2,0,0,20391,2,3,0,6,0
18,301,02001,0,0,0,20,0,12,0,0,0,6,0,0,53842,6,12,0,20,0
18,301,02005,0,1,30,36,24,30,9,5,0,17,2,39,152691,19,39,5,60,1
18,301,02006,2,0,0,165,0,73,0,0,2,32,0,0,172101,32,73,2,165,2
18,301,02007,1,1,10,120,46,73,17,3,1,37,3,19,192554,40,90,4,166,2
18,301,02008,0,5,260,226,136,105,66,31,0,54,12,319,425788,66,171,31,362,5
18,301,02009,1,1,30,86,85,49,39,20,1,26,4,49,257905,30,88,21,171,2
18,301,02010,0,1,30,68,46,35,14,5,0,19,3,43,139101,22,49,5,114,1
18,301,02011,0,0,0,138,0,66,0,0,0,29,0,0,249239,29,66,0,138,0
18,301,02012,2,1,30,147,33,60,16,4,4,22,1,35,305606,23,76,8,180,3
18,302,02013,0,1,30,133,48,66,19,5,0,28,4,50,279281,32,85,5,181,1
18,302,02014,2,3,150,144,145,75,53,25,3,40,15,315,280213,55,128,28,289,5
18,302,02015,0,0,0,165,10,99,2,0,0,56,1,0,258184,57,101,0,175,0
18,302,02016,0,1,10,40,37,28,11,4,0,17,3,14,80847,20,39,4,77,1
18,302,02017,1,0,0,41,0,27,0,0,2,14,0,0,108950,14,27,2,41,1
18,303,02018,0,4,90,90,94,60,37,10,0,35,12,135,234235,47,97,10,184,4
18,303,02019,1,0,0,103,0,61,0,0,3,38,0,0,195983,38,61,3,103,1
18,303,02020,0,0,0,146,0,75,0,0,0,30,0,0,305925,30,75,0,146,0
18,303,02021,0,1,10,158,18,107,5,3,0,53,1,15,142775,54,112,3,176,1
18,303,02022,4,3,330,268,75,157,36,10,7,75,15,350,365608,90,193,17,343,7
18,303,02023,1,1,30,175,28,98,11,3,1,54,3,40,194927,57,109,4,203,2
18,303,02024,3,1,50,123,64,67,26,14,6,40,5,60,102405,45,93,20,187,4
18,303,02025,0,0,0,159,0,81,0,0,0,38,0,0,129853,38,81,0,159,0
18,303,02140,0,0,0,30,0,16,0,0,0,10,0,0,21538,10,16,0,30,0
18,304,02026,1,1,30,235,38,117,13,5,2,66,2,35,242601,68,130,7,273,2
18,304,02027,0,0,0,36,6,19,4,0,0,6,2,0,123216,8,23,0,42,0
18,304,02028,0,1,30,154,32,84,13,3,0,38,3,35,253548,41,97,3,186,1
18,304,02029,0,1,100,114,102,67,32,16,0,44,7,127,200381,51,99,16,216,1
18,304,02030,2,0,0,171,0,74,0,0,3,58,0,0,137213,58,74,3,171,2
18,305,02031,5,0,0,204,0,110,0,0,7,51,0,0,197217,51,110,7,204,5
18,305,02032,3,0,0,252,10,140,3,0,5,80,1,0,330378,81,143,5,262,3
18,305,02033,2,0,0,149,0,69,0,0,2,33,0,0,228206,33,69,2,149,2
18,305,02034,4,1,30,236,45,126,15,5,7,57,5,40,330491,62,141,12,281,5
18,305,02035,1,2,250,64,241,23,114,72,2,9,25,415,406630,34,137,74,305,3
18,305,02036,0,1,30,302,54,172,22,8,0,91,4,40,175085,95,194,8,356,1
18,305,02037,0,1,30,83,36,41,14,5,0,31,3,65,223788,34,55,5,119,1
18,305,02038,1,1,30,60,50,35,23,5,2,22,7,38,228523,29,58,7,110,2
18,305,02039,0,1,10,153,47,78,17,5,0,59,4,36,303767,63,95,5,200,1
18,305,02040,0,3,90,73,147,46,61,20,0,25,13,146,398921,38,107,20,220,3
18,306,02041,2,1,30,231,47,123,18,4,2,77,8,35,469860,85,141,6,278,3
18,306,02042,3,1,30,249,28,125,7,2,3,73,2,50,343675,75,132,5,277,4
18,306,02043,0,2,350,82,302,48,139,75,0,26,32,773,281996,58,187,75,384,2
18,306,02044,0,0,0,121,0,79,0,0,0,44,0,0,215675,44,79,0,121,0
18,306,02045,1,1,50,143,81,80,29,12,2,54,7,65,346404,61,109,14,224,2
18,306,02046,0,0,0,103,0,68,0,0,0,77,0,0,139657,77,68,0,103,0
18,306,02047,0,0,0,46,0,34,0,0,0,23,0,0,113643,23,34,0,46,0
18,307,02048,0,0,0,127,9,81,4,0,0,41,3,0,135531,44,85,0,136,0
18,307,02049,4,1,10,144,54,66,18,7,6,32,2,20,210138,34,84,13,198,5
18,307,02050,0,0,0,93,0,62,0,0,0,33,0,0,148919,33,62,0,93,0
18,307,02051,0,0,0,59,0,30,0,0,0,63,0,0,107120,63,30,0,59,0
18,307,02052,0,1,50,120,65,73,23,10,0,42,6,70,250516,48,96,10,185,1
18,307,02053,0,1,30,100,35,63,13,5,0,33,2,51,114124,35,76,5,135,1
18,307,02054,1,0,0,59,0,31,0,0,2,21,0,0,74850,21,31,2,59,1
18,308,02053,0,0,0,97,0,35,0,0,0,27,0,0,29513,27,35,0,97,0
18,308,02054,0,0,0,13,0,11,0,0,0,6,0,0,13950,6,11,0,13,0
18,308,02055,1,1,100,57,41,34,13,3,1,22,7,105,139717,29,47,4,98,2
18,308,02056,0,1,15,35,44,24,15,3,0,25,4,26,233713,29,39,3,79,1
18,308,02057,0,2,40,58,53,34,21,8,0,39,3,81,169671,42,55,8,111,2
18,308,02058,1,0,0,66,0,34,0,0,2,28,0,0,98431,28,34,2,66,1
18,309,02059,0,1,15,73,27,39,10,3,0,28,3,20,102173,31,49,3,100,1
18,309,02060,1,4,90,139,128,74,49,14,2,50,16,165,416582,66,123,16,267,5
18,309,02061,1,1,100,130,141,92,58,30,1,107,28,125,437951,135,150,31,271,2
18,309,02062,0,4,130,72,256,38,92,29,0,50,22,290,370498,72,130,29,328,4
18,310,02063,0,0,0,119,6,97,4,0,0,59,2,0,158085,61,101,0,125,0
18,310,02064,0,3,1600,91,299,65,113,90,0,51,31,1624,270230,82,178,90,390,3
18,310,02065,1,1,30,158,34,89,17,5,2,55,6,47,159559,61,106,7,192,2
18,310,02066,0,1,15,103,38,65,16,3,0,41,15,45,220276,56,81,3,141,1
18,310,02067,1,1,15,176,24,112,11,3,1,70,5,20,169489,75,123,4,200,2
18,310,02068,0,0,0,77,0,52,0,0,0,72,0,0,159192,72,52,0,77,0
18,310,02069,1,2,80,139,104,73,32,14,1,47,9,97,187408,56,105,15,243,3
18,311,02070,1,0,0,180,0,107,0,0,3,56,0,0,152111,56,107,3,180,1
18,311,02071,0,1,30,65,55,51,24,5,0,43,14,48,198579,57,75,5,120,1
18,311,02072,1,1,30,111,28,71,13,3,2,46,3,42,144009,49,84,5,139,2
18,311,02073,2,2,25,183,68,105,30,6,5,61,6,49,197591,67,135,11,251,4
18,311,02074,0,1,10,233,33,128,16,2,0,79,5,22,324970,84,144,2,266,1
18,311,02075,1,0,0,149,22,117,10,0,1,81,4,35,133510,85,127,1,171,1
18,312,02076,0,0,0,131,0,79,0,0,0,47,0,0,167157,47,79,0,131,0
18,312,02077,0,0,0,161,40,82,16,0,0,108,8,23,182685,116,98,0,201,0
18,312,02078,0,3,390,71,409,36,163,60,0,47,37,1155,195263,84,199,60,480,3
18,312,02079,3,1,30,103,29,54,13,5,2,41,4,37,184602,45,67,7,132,4
18,312,02080,0,1,30,104,41,52,17,5,0,37,4,37,201748,41,69,5,145,1
18,312,02081,0,1,30,35,78,23,25,12,0,18,4,37,131571,22,48,12,113,1
18,313,02082,4,2,40,150,86,76,32,12,5,47,10,77,163864,57,108,17,236,6
18,313,02083,1,0,0,66,0,33,0,0,1,24,0,0,85825,24,33,1,66,1
18,313,02084,0,1,15,74,28,45,12,3,0,65,4,22,146101,69,57,3,102,1
18,313,02085,0,1,50,165,95,92,41,18,0,52,11,57,327150,63,133,18,260,1
18,313,02086,0,0,0,66,0,39,0,0,0,19,0,0,114782,19,39,0,66,0
18,313,02087,0,2,25,97,61,69,25,6,0,36,6,69,228749,42,94,6,158,2
18,314,02088,1,2,80,114,114,52,38,13,2,32,7,92,294554,39,90,15,228,3
18,314,02089,0,2,60,72,103,35,48,13,0,33,16,84,286783,49,83,13,175,2
18,314,02090,0,2,45,71,65,34,27,8,0,50,8,89,278218,58,61,8,136,2
18,314,02091,0,0,0,8,0,3,0,0,0,2,0,0,89779,2,3,0,8,0
18,315,02092,0,1,30,42,36,20,17,5,0,11,8,37,49048,19,37,5,78,1
18,315,02093,0,1,30,54,78,22,32,18,0,12,5,37,76496,17,54,18,132,1
18,315,02094,0,1,10,56,28,30,10,3,0,12,1,17,33545,13,40,3,84,1
18,315,02095,0,1,15,22,26,13,13,3,0,8,3,27,53023,11,26,3,48,1
18,316,02096,1,0,0,62,20,28,10,0,2,21,5,20,291693,26,38,2,82,1
18,316,02097,0,3,630,229,244,117,86,18,0,55,31,818,704438,86,203,18,473,3
18,316,02098,0,1,30,58,34,25,11,3,0,16,2,45,124064,18,36,3,92,1
18,316,02099,1,0,0,54,0,26,0,0,1,14,0,0,324155,14,26,1,54,1
18,316,02100,2,1,30,622,40,284,19,4,2,182,3,57,291568,185,303,6,662,3
18,317,02101,0,1,100,53,142,30,65,30,0,25,8,147,278125,33,95,30,195,1
18,317,02102,0,4,100,81,116,49,47,16,0,28,10,127,164614,38,96,16,197,4
18,317,02103,0,0,0,21,0,9,0,0,0,2,0,0,242415,2,9,0,21,0
18,317,02104,0,0,0,84,0,44,0,0,0,21,0,0,261305,21,44,0,84,0
18,317,02105,1,0,0,64,0,37,0,0,2,20,0,0,281625,20,37,2,64,1
18,318,02106,0,0,0,329,10,146,4,0,0,63,3,20,121373,66,150,0,339,0
18,318,02107,0,1,100,324,79,149,42,27,0,68,6,159,166897,74,191,27,403,1
18,318,02108,0,1,30,67,35,27,17,5,0,11,3,37,202943,14,44,5,102,1
18,318,02109,2,0,0,142,0,66,0,0,4,31,0,0,168046,31,66,4,142,2
18,319,02110,0,2,130,28,130,13,63,40,0,6,18,142,156094,24,76,40,158,2
18,319,02111,0,0,0,49,10,28,4,0,0,16,2,20,127336,18,32,0,59,0
18,319,02112,0,1,30,70,30,41,15,5,0,23,4,37,266669,27,56,5,100,1
18,319,02114,0,0,0,27,6,14,3,0,0,6,3,0,58371,9,17,0,33,0
18,319,02115,1,0,0,112,0,68,0,0,1,38,0,0,130242,38,68,1,112,1
18,320,02004,0,1,15,0,32,0,13,3,0,7,3,22,22001,10,13,3,32,1
18,320,02018,0,0,0,12,0,7,0,0,0,4,0,0,9500,4,7,0,12,0
18,320,02110,0,0,0,3,0,2,0,0,0,1,0,0,8031,1,2,0,3,0
18,320,02113,0,0,0,54,0,25,0,0,0,11,0,0,49902,11,25,0,54,0
18,320,02114,1,0,0,109,8,59,4,0,1,27,3,5,158868,30,63,1,117,1
18,320,02115,0,1,15,83,32,45,14,3,0,34,3,25,233510,37,59,3,115,1
18,321,02116,0,1,36,11,61,5,22,10,0,3,6,48,155333,9,27,10,72,1
18,321,02117,0,0,0,22,0,9,0,0,0,3,0,0,32350,3,9,0,22,0
18,321,02118,1,0,0,69,0,35,0,0,2,18,0,0,169229,18,35,2,69,1
18,321,02119,2,2,60,128,91,53,30,6,2,22,12,105,262372,34,83,8,219,4
18,321,02120,0,0,0,57,0,32,0,0,0,15,0,0,121551,15,32,0,57,0
18,321,02121,0,0,0,38,0,14,0,0,0,4,0,0,134298,4,14,0,38,0
18,321,02122,0,0,0,42,0,19,0,0,0,6,0,0,126604,6,19,0,42,0
18,321,02123,0,0,0,70,0,38,0,0,0,15,0,0,78280,15,38,0,70,0
18,321,02124,2,0,0,68,0,46,0,0,2,33,0,0,111834,33,46,2,68,2
18,321,02125,0,4,70,176,157,96,63,13,0,45,19,123,238732,64,159,13,333,4
18,321,02126,0,1,15,14,24,7,11,3,0,4,3,39,48227,7,18,3,38,1
18,321,02141,0,0,0,9,0,6,0,0,0,3,0,0,38061,3,6,0,9,0
18,322,02126,0,0,0,3,30,1,14,0,0,0,6,12,28400,6,15,0,33,0
18,322,02127,0,1,10,21,84,11,36,7,0,6,7,18,64203,13,47,7,105,1
18,322,02129,0,0,0,0,0,0,0,0,0,0,0,0,6309,0,0,0,0,0
18,322,02130,1,2,45,109,88,49,36,8,2,29,13,99,143371,42,85,10,197,3
18,322,02131,0,0,0,37,4,25,1,0,0,13,0,3,49201,13,26,0,41,0
18,323,02132,0,1,20,64,30,29,15,7,0,13,2,27,67656,15,44,7,94,1
18,323,02133,0,2,25,98,48,61,19,5,0,30,5,33,127252,35,80,5,146,2
18,323,02134,2,0,0,183,0,83,0,0,2,53,0,0,202110,53,83,2,183,2
18,323,02135,1,0,0,72,10,41,4,0,3,22,2,0,67544,24,45,3,82,1
18,323,02136,1,1,30,72,118,40,41,22,2,26,15,59,154826,41,81,24,190,2
18,323,02137,1,0,0,38,0,19,0,0,3,11,0,0,40559,11,19,3,38,1
18,323,02138,0,0,0,59,0,40,0,0,0,25,0,0,90360,25,40,0,59,0
18,323,02139,0,0,0,6,0,3,0,0,0,1,0,0,7588,1,3,0,6,0
18,323,02142,0,0,0,12,0,6,0,0,0,3,0,0,13642,3,6,0,12,0
18,324,02018,0,0,0,65,10,36,5,0,0,23,2,20,139149,25,41,0,75,0
18,324,02024,0,0,0,0,0,0,0,0,0,0,0,0,2994,0,0,0,0,0
18,324,02025,0,0,0,43,0,23,0,0,0,13,0,0,55011,13,23,0,43,0
18,324,02116,0,0,0,3,0,1,0,0,0,0,0,0,14357,0,1,0,3,0
18,324,02132,0,0,0,18,0,11,0,0,0,5,0,0,17508,5,11,0,18,0
18,324,02138,0,0,0,0,0,0,0,0,0,0,0,0,3652,0,0,0,0,0
18,324,02139,0,0,0,52,0,26,0,0,0,13,0,0,69741,13,26,0,52,0
18,324,02140,1,0,0,148,0,73,0,0,2,37,0,0,81979,37,73,2,148,1
18,324,02141,2,0,0,68,6,31,3,0,1,16,1,0,153747,17,34,1,74,2
18,324,02142,0,0,0,94,0,49,0,0,0,27,0,0,49715,27,49,0,94,0
18,324,02143,0,0,0,87,0,47,0,0,0,27,0,0,124585,27,47,0,87,0
18,324,02144,3,0,0,91,0,34,0,0,3,15,0,0,235403,15,34,3,91,3
18,324,02146,0,0,0,0,0,0,0,0,0,0,0,0,2234,0,0,0,0,0
18,325,02145,0,0,0,11,0,7,0,0,0,5,0,0,8398,5,7,0,11,0
18,325,02146,0,0,0,87,0,64,0,0,0,31,0,0,95338,31,64,0,87,0
18,325,02147,0,0,0,92,0,61,0,0,0,29,0,0,123346,29,61,0,92,0
18,325,02148,1,1,30,99,112,59,33,17,1,38,11,57,202353,49,92,18,211,2
18,325,02149,2,1,30,288,47,234,18,5,2,51,5,47,473585,56,252,7,335,3
18,325,02150,0,0,0,81,0,51,0,0,0,70,0,0,25246,70,51,0,81,0
18,326,02041,1,0,0,33,0,19,0,0,1,10,0,0,18600,10,19,1,33,1
18,326,02145,0,0,0,85,0,45,0,0,0,29,0,0,81209,29,45,0,85,0
18,326,02146,0,0,0,3,0,1,0,0,0,0,0,0,1008,0,1,0,3,0
18,326,02148,0,0,0,35,0,16,0,0,0,8,0,0,4799,8,16,0,35,0
18,326,02149,0,0,0,29,0,22,0,0,0,4,0,0,52627,4,22,0,29,0
18,326,02150,0,0,0,53,12,24,5,0,0,99,2,0,85616,101,29,0,65,0
18,326,02151,3,1,30,200,42,108,23,5,4,73,2,37,242565,75,131,9,242,4
18,326,02152,1,1,30,233,65,119,28,5,2,77,5,67,212318,82,147,7,298,2
18,326,02153,2,0,0,129,0,75,0,0,4,46,0,0,132773,46,75,4,129,2
19,327,02154,1,0,0,60,0,11,0,0,3,42,3,0,126886,45,11,3,60,1
19,327,02155,1,0,0,35,0,1,0,0,0,49,0,0,70125,49,1,0,35,1
19,327,02156,2,0,0,64,0,16,0,0,1,41,0,0,74644,41,16,1,64,2
19,327,02157,1,0,0,42,0,5,0,0,0,23,0,0,66670,23,5,0,42,1
19,327,02158,1,0,0,20,0,10,0,0,1,15,0,0,60663,15,10,1,20,1
19,327,02159,1,0,0,77,13,8,8,0,1,28,2,33,113516,30,16,1,90,1
19,327,02160,1,0,0,59,0,13,0,0,0,41,0,0,45818,41,13,0,59,1
19,327,02161,2,1,5,46,0,33,0,0,0,53,1,5,94322,54,33,0,46,3
19,327,02162,1,0,0,53,42,20,7,0,0,27,154,13,197233,181,27,0,95,1
19,327,02163,3,0,0,48,2,51,0,0,8,232,3,6,165513,235,51,8,50,3
19,327,02164,4,0,0,12,0,35,0,0,6,62,0,0,204464,62,35,6,12,4
19,327,02165,0,2,6,0,2,2,0,0,0,22,3,6,109222,25,2,0,2,2
19,327,99999,0,3,820,0,90,0,32,24,0,0,45,1284,222167,45,32,24,90,3
19,328,02166,0,0,47.38888931274414,46,11,8,5.02253246307373,2.79411768913269,0,51,18,53.90606307983398,373776,69,13.022532,2.7941177,57,0
19,328,02167,2,1,0,133,12,11,1,1,0,103,4,0,299498,107,12,1,145,3
19,328,02168,1,2,35,0,0,0,5,5,0,31,6,35,117540,37,5,5,0,3
19,328,02169,4,0,0,47,0,11,0,0,6,33,0,0,127369,33,11,6,47,4
19,328,02170,7,0,0,12,0,9,0,0,1,59,6,0,201988,65,9,1,12,7
19,328,02171,2,2,55,104,90,9,9,8,1,59,18,59,298458,77,18,9,194,4
19,328,02172,1,1,10,56,0,26,3,3,0,59,1,10,199609,60,29,3,56,2
19,328,02173,1,2,80,31,5,8,14,14,0,44,9,80,216931,53,22,14,36,3
19,328,02174,1,0,0,25,0,9,0,0,0,53,0,0,218232,53,9,0,25,1
19,328,02175,1,1,30,171,76,7,18,7,1,89,8,90,290722,97,25,8,247,2
19,328,02176,3,1,10,70,5,11,6,1,0,86,8,30,414846,94,17,1,75,4
19,328,02177,3,1,0,43,3,17,0,0,1,64,5,0,329032,69,17,1,46,4
19,328,02178,0,0,0,110,35,23,2,0,0,129,14,0,323410,143,25,0,145,0
19,328,99999,0,10,1486,0,46,0,62,56,0,0,192,1612,461228,192,62,56,46,10
19,329,02179,2,0,0,25,0,10,0,0,1,23,0,0,103916,23,10,1,25,2
19,329,02180,0,1,0,13,0,5,2,0,0,28,3,0,155236,31,7,0,13,1
19,329,02181,1,0,0,60,0,11,0,0,0,49,0,0,218137,49,11,0,60,1
19,329,02182,0,0,0,32,0,11,0,0,0,40,0,0,227397,40,11,0,32,0
19,329,02183,1,0,0,77,3,8,0,0,3,53,1,0,326490,54,8,3,80,1
19,329,02184,3,1,10,64,37,7,9,1,0,69,5,60,343901,74,16,1,101,4
19,329,02185,1,0,0,48,0,10,0,0,0,74,1,0,248583,75,10,0,48,1
19,329,02186,2,0,0,11,0,0,0,0,0,90,1,0,186726,91,0,0,11,2
19,329,02187,1,0,0,52,0,4,0,0,0,56,0,0,286165,56,4,0,52,1
19,329,02188,6,0,0,23,0,5,0,0,1,69,0,0,244026,69,5,1,23,6
19,329,02189,3,0,0,6,0,3,0,0,1,60,0,0,110333,60,3,1,6,3
19,329,02190,1,0,0,15,0,10,0,0,1,72,0,0,185353,72,10,1,15,1
19,329,99999,0,6,950,0,104,0,78,65,0,0,25,1175,182478,25,78,65,104,6
19,330,02191,10,1,10,120,15,60,5,5,7,283,1,10,284377,284,65,12,135,11
19,330,02192,1,0,0,10,0,12,0,0,0,36,0,0,308518,36,12,0,10,1
19,330,02193,0,0,0,45,0,8,0,0,0,43,0,0,326120,43,8,0,45,0
19,330,02194,1,0,0,81,0,25,0,0,4,105,0,0,291252,105,25,4,81,1
19,330,02195,2,0,0,45,0,10,0,0,6,72,0,0,368307,72,10,6,45,2
19,330,02196,1,0,0,98,0,17,0,0,0,84,0,0,430179,84,17,0,98,1
19,330,02197,1,0,0,3,0,3,0,0,0,30,0,0,142008,30,3,0,3,1
19,330,02198,0,0,0,61,0,5,0,0,0,39,0,0,224142,39,5,0,61,0
19,330,02199,9,0,0,156,3,20,5,0,1,133,1,30,303599,134,25,1,159,9
19,330,99999,0,5,594,0,258,0,168,91,0,0,51,746,328412,51,168,91,258,5
19,331,02200,2,0,0,29,0,12,0,0,2,34,0,0,198706,34,12,2,29,2
19,331,02201,0,0,0,54,9,13,0,0,0,49,1,2,237599,50,13,0,63,0
19,331,02202,0,0,0,41,0,13,0,0,0,51,0,0,169008,51,13,0,41,0
19,331,02203,1,0,0,35,0,35,0,0,5,23,0,0,83738,23,35,5,35,1
19,331,02204,0,1,2,76,0,12,0,0,0,87,1,2,248704,88,12,0,76,1
19,331,02205,5,0,0,29,0,3,0,0,0,74,0,0,250463,74,3,0,29,5
19,331,02206,0,0,0,78,0,89,0,0,0,42,0,0,141193,42,89,0,78,0
19,331,02207,1,1,30,18,4,9,4,4,1,30,1,30,136730,31,13,5,22,2
19,331,99999,0,2,605,0,342,0,75,67,0,0,12,664,209496,12,75,67,342,2
19,332,02208,1,0,0,128,0,11,0,0,8,48,0,0,199444,48,11,8,128,1
19,332,02209,1,0,0,16,0,8,0,0,1,27,0,0,251334,27,8,1,16,1
19,332,02210,1,0,0,18,0,10,0,0,0,336,0,0,204740,336,10,0,18,1
19,332,02211,1,0,0,31,0,5,0,0,0,40,0,0,205323,40,5,0,31,1
19,332,02212,0,0,0,39,0,49,0,0,0,27,0,0,275321,27,49,0,39,0
19,332,02213,1,0,0,54,0,16,0,0,4,457,0,0,202080,457,16,4,54,1
19,332,02214,4,0,0,42,0,29,0,0,8,355,3,0,343800,358,29,8,42,4
19,332,02215,3,0,0,64,0,9,0,0,0,36,0,0,143906,36,9,0,64,3
19,332,02216,0,1,30,9,7,3,7,6,0,28,4,39,210644,32,10,6,16,1
19,332,02217,1,0,0,24,0,9,1,0,0,51,4,0,156365,55,10,0,24,1
19,332,02218,2,1,20,32,18,30,2,2,0,40,10,40,274578,50,32,2,50,3
19,332,02219,2,0,0,64,0,17,0,0,1,57,0,0,269765,57,17,1,64,2
19,332,02220,0,1,15,48,37,6,17,11,0,45,11,40,371368,56,23,11,85,1
19,332,02221,1,0,0,80,0,7,0,0,0,40,0,0,210056,40,7,0,80,1
19,332,02222,0,1,20,48,0,9,0,0,0,32,15,30,330281,47,9,0,48,1
19,332,99999,0,5,600,0,96,0,74,48,0,0,13,731,289533,13,74,48,96,5
19,333,02223,0,3,56,17,34,19,18,8,0,37,57,84,274074,94,37,8,51,3
19,333,02224,1,2,20,9,5,0,6,1,0,23,14,27,284072,37,6,1,14,3
19,333,02225,3,0,0,168,0,40,0,0,2,58,0,0,179908,58,40,2,168,3
19,333,02226,0,1,5,10,10,0,6,2,0,29,20,20,278922,49,6,2,20,1
19,333,02227,2,0,0,177,5,60,5,0,41,35,5,10,195627,40,65,41,182,2
19,333,02228,1,1,15,46,30,9,3,3,4,31,3,17,265336,34,12,7,76,2
19,333,02229,2,0,0,14,0,1,0,0,0,50,0,0,335770,50,1,0,14,2
19,333,02230,1,0,0,43,0,6,0,0,0,66,0,0,310375,66,6,0,43,1
19,333,02231,1,0,0,47,0,5,0,0,0,77,0,0,202064,77,5,0,47,1
19,333,02232,2,0,0,2,0,8,0,0,4,38,0,0,158024,38,8,4,2,2
19,333,02233,2,0,0,8,0,8,0,0,0,60,0,0,190885,60,8,0,8,2
19,333,02234,1,0,0,41,0,6,0,0,5,35,0,0,252477,35,6,5,41,1
19,333,02235,6,0,0,141,0,57,0,0,10,101,0,0,363928,101,57,10,141,6
19,333,02236,2,1,40,34,0,8,0,0,0,56,10,70,189105,66,8,0,34,3
19,333,02237,1,0,0,35,0,25,0,0,1,33,0,0,234522,33,25,1,35,1
19,333,02238,2,0,0,37,0,28,0,0,3,67,0,0,227586,67,28,3,37,2
19,333,02239,1,0,0,209,0,9,0,0,0,65,0,0,273285,65,9,0,209,1
19,333,02240,1,0,0,35,0,18,0,0,1,59,0,0,220145,59,18,1,35,1
19,333,02241,0,2,300,37,5,12,35,15,0,125,72,600,446887,197,47,15,42,2
19,333,02242,1,0,0,43,0,13,0,0,0,55,0,0,257571,55,13,0,43,1
19,333,02243,1,0,0,12,0,19,0,0,3,30,0,0,226859,30,19,3,12,1
19,333,02244,1,1,10,34,0,8,0,0,2,67,1,10,319322,68,8,2,34,2
19,333,02245,0,0,0,42,0,3,0,0,0,60,0,0,250458,60,3,0,42,0
19,333,02246,1,1,15,34,1,10,5,5,1,63,2,15,176368,65,15,6,35,2
19,333,02247,1,0,0,99,0,25,0,0,2,41,0,0,172702,41,25,2,99,1
19,333,02248,3,0,0,57,0,30,0,0,5,76,0,0,257466,76,30,5,57,3
19,333,99999,0,11,1732,0,370,0,276,180,0,0,19858,2183,559740,19858,276,180,370,11
19,334,02249,0,2,57,78,28,18,8,8,0,40,3,59,190802,43,26,8,106,2
19,334,02250,1,0,0,91,0,5,0,0,0,38,4,0,222033,42,5,0,91,1
19,334,02251,0,0,0,75,0,18,0,0,0,52,0,0,204818,52,18,0,75,0
19,334,02252,0,0,0,28,0,0,0,0,0,19,0,0,127785,19,0,0,28,0
19,334,02253,1,0,0,48,0,8,0,0,0,43,0,0,188252,43,8,0,48,1
19,334,02254,0,0,0,93,0,19,0,0,0,34,0,0,184527,34,19,0,93,0
19,334,02255,0,0,0,19,0,8,0,0,0,40,0,0,159782,40,8,0,19,0
19,334,02256,1,0,0,50,0,15,0,0,3,38,0,0,127661,38,15,3,50,1
19,334,02257,1,0,0,55,0,12,0,0,1,48,0,0,164456,48,12,1,55,1
19,334,02258,1,1,10,2,0,6,3,2,2,14,2,10,77904,16,9,4,2,2
19,334,02259,1,1,0,41,1,6,1,1,0,24,1,0,111331,25,7,1,42,2
19,334,02260,2,0,0,31,0,9,0,0,0,28,0,0,87373,28,9,0,31,2
19,334,02261,1,0,0,86,2,17,0,0,1,59,2,0,195232,61,17,1,88,1
19,334,02262,1,1,40,12,0,16,0,0,0,115,6,40,201889,121,16,0,12,2
19,334,02263,1,0,0,288,0,36,0,0,0,71,0,0,218624,71,36,0,288,1
19,334,02264,0,0,0,25,0,12,0,0,0,70,0,0,202511,70,12,0,25,0
19,334,02265,0,1,30,80,1,12,2,1,0,49,703,30,167478,752,14,1,81,1
19,334,02266,3,0,0,97,0,33,0,0,5,97,0,0,181375,97,33,5,97,3
19,334,02267,0,0,0,18,0,11,0,0,0,40,0,0,153136,40,11,0,18,0
19,334,99999,0,4,856,0,100,0,62,41,0,0,1835,1056,330083,1835,62,41,100,4
19,335,02268,0,2,247,60,10,33,24,19,0,71,9,263,163032,80,57,19,70,2
19,335,02269,1,2,45,13,4,12,2,0,0,15,12,45,123598,27,14,0,17,3
19,335,02270,1,0,0,14,4,7,2,0,0,29,2,11,119292,31,9,0,18,1
19,335,02271,0,3,80,4,30,1,19,16,0,5,52,80,106430,57,20,16,34,3
19,335,02272,2,3,120,5,29,9,13,7,0,19,34,144,186915,53,22,7,34,5
19,335,02273,2,1,0,17,54,8,16,3,4,20,26,4,161891,46,24,7,71,3
19,335,02274,1,0,0,23,6,9,0,0,1,32,1,0,115891,33,9,1,29,1
19,335,02275,9,1,150,80,37,26,24,21,4,61,21,162,178103,82,50,25,117,10
19,335,02276,12,0,0,155,0,29,0,0,7,111,0,0,150814,111,29,7,155,12
19,335,02277,1,0,0,27,0,5,0,0,0,77,0,0,119363,77,5,0,27,1
19,335,02278,3,0,0,87,0,25,0,0,5,72,0,0,263187,72,25,5,87,3
19,335,02279,4,0,0,81,0,13,0,0,2,48,0,0,165408,48,13,2,81,4
19,335,02280,16,0,0,24,0,15,0,0,0,271,0,0,118567,271,15,0,24,16
19,335,02281,2,0,0,24,1,4,0,0,0,86,1,0,173087,87,4,0,25,2
19,335,02282,0,0,0,40,0,9,0,0,0,108,0,0,136642,108,9,0,40,0
19,335,02283,1,0,0,37,0,15,0,0,2,262,176,0,206977,438,15,2,37,1
19,335,02284,8,0,0,71,0,36,0,0,10,69,0,0,212341,69,36,10,71,8
19,335,02285,9,0,0,131,0,4,0,0,0,115,0,0,237398,115,4,0,131,9
19,335,02286,4,0,0,6,0,6,0,0,1,108,0,0,263064,108,6,1,6,4
19,335,02287,1,0,0,39,2,31,0,0,6,40,2,0,187529,42,31,6,41,1
19,335,02288,2,0,0,50,0,33,0,0,0,42,0,0,147177,42,33,0,50,2
19,335,02289,2,0,0,51,2,8,1,0,0,50,4,0,215943,54,9,0,53,2
19,335,02290,3,0,0,65,0,19,0,0,2,161,0,0,152844,161,19,2,65,3
19,335,02291,6,0,0,20,0,10,0,0,0,90,0,0,218425,90,10,0,20,6
19,335,02292,3,0,0,44,0,22,0,0,0,1067,0,0,150252,1067,22,0,44,3
19,335,02293,3,0,0,18,0,1,0,0,0,57,0,0,206945,57,1,0,18,3
19,335,02294,3,0,0,18,0,16,0,0,3,51,1,0,167325,52,16,3,18,3
19,335,02295,1,0,0,33,0,15,0,0,0,74,0,0,266338,74,15,0,33,1
19,335,02296,5,0,0,36,0,26,0,0,0,86,1,0,180952,87,26,0,36,5
19,335,02297,2,0,0,21,0,12,0,0,0,215,0,0,189294,215,12,0,21,2
19,335,02298,5,0,0,82,0,48,0,0,5,70,0,0,151337,70,48,5,82,5
19,335,99999,0,25,3634.010639190674,0,2238,0,1056.118511199951,328.1489362716675,0,0,4567,5822.22420501709,2276742,4567,1056.1185,328.14893,2238,25
19,336,02299,0,1,50,75,20,13,16,7,0,34,3,70,183556,37,29,7,95,1
19,336,02300,1,0,0,45,0,15,0,0,3,40,0,0,217136,40,15,3,45,1
19,336,02301,3,0,0,92,0,25,0,0,14,101,0,0,244322,101,25,14,92,3
19,336,02302,4,0,0,50,0,20,0,0,1,35,0,0,151231,35,20,1,50,4
19,336,02303,12,0,0,9,0,23,0,0,0,110,4,0,334796,114,23,0,9,12
19,336,02304,1,0,0,58,10,15,7,0,0,70,13,7,386569,83,22,0,68,1
19,336,02305,0,0,0,73,0,47,2,0,0,65,1,8,310652,66,49,0,73,0
19,336,02306,1,0,0,44,0,12,1,0,0,38,3,1,139413,41,13,0,44,1
19,336,02307,0,2,27,0,15,6,6,5,0,8,12,27,135314,20,12,5,15,2
19,336,02308,1,0,0,98,0,25,0,0,1,261,2,0,314833,263,25,1,98,1
19,336,02309,4,0,0,45,0,29,0,0,5,43,0,0,146705,43,29,5,45,4
19,336,02310,4,1,25,49,0,22,9,5,0,104,5,29,293009,109,31,5,49,5
19,336,02311,5,1,10,41,3,14,2,1,0,62,1056,18,241060,1118,16,1,44,6
19,336,02312,2,1,171,23,4,13,40,31,0,34,3407,177,215088,3441,53,31,27,3
19,336,02313,1,0,0,34,14,11,3,0,2,83,5,20,364385,88,14,2,48,1
19,336,02314,0,0,0,21,4,30,1,0,0,61,1,0,405714,62,31,0,25,0
19,336,02315,0,1,10,46,16,25,15,10,0,39,3,15,231068,42,40,10,62,1
19,336,99999,0,9,1617,0,530,0,291,212,0,0,71,2587,852480,71,291,212,530,9
19,337,02316,6,0,0,14,0,5,0,0,0,86,0,0,242974,86,5,0,14,6
19,337,02317,3,0,0,20,0,1,0,0,0,104,0,0,380903,104,1,0,20,3
19,337,02318,3,1,25,95,0,29,3,3,2,73,10001,25,330287,10074,32,5,95,4
19,337,02319,1,0,0,42,0,29,7,0,0,105,323,0,256075,428,36,0,42,1
19,337,02320,0,0,0,0,0,0,0,0,0,54,4,20,225200,58,0,0,0,0
19,337,02321,2,0,0,43,1,12,0,0,0,54,6,0,176490,60,12,0,44,2
19,337,02322,7,0,0,42,0,3,0,0,0,58,0,0,191673,58,3,0,42,7
19,337,02323,1,2,256,42,107,22,49,21,0,30,13,326,182845,43,71,21,149,3
19,337,02324,0,0,0,16,4,4,3,0,0,19,18,6,217171,37,7,0,20,0
19,337,02325,1,3,256,38,23,15,55,39,0,1917,260,261,294628,2177,70,39,61,4
19,337,02326,0,0,0,41,0,19,0,0,0,63,1,0,200918,64,19,0,41,0
19,337,02327,10,0,0,44,5,17,4,0,9,84,3,0,319213,87,21,9,49,10
19,337,02328,0,0,0,117,7,36,2,0,0,75,3,0,285271,78,38,0,124,0
19,337,02329,0,0,0,6,0,6,3,0,0,29,207,25,171582,236,9,0,6,0
19,337,02330,2,0,0,9,0,10,2,0,1,59,2,10,226119,61,12,1,9,2
19,337,02331,0,0,0,41,0,13,0,0,0,53,0,0,213996,53,13,0,41,0
19,337,02332,3,1,20,9,29,26,3,3,3,48,3,20,189893,51,29,6,38,4
19,337,02333,0,1,50,20,12,20,4,4,0,55,2,50,196968,57,24,4,32,1
19,337,02334,1,0,0,22,0,20,0,0,3,37,0,0,164465,37,20,3,22,1
19,337,02335,2,0,0,17,0,14,0,0,0,48,0,0,160976,48,14,0,17,2
19,337,02336,0,0,0,25,0,4,0,0,0,44,0,0,203262,44,4,0,25,0
19,337,02337,1,1,0,31,1,18,1,1,2,61,1,0,174545,62,19,3,32,2
19,337,99999,0,29,2486.27184677124,0,1366,0,565.1288814544678,241.1855673789978,0,0,5915,3594.199752807617,5001716,5915,565.12891,241.18556,1366,29
19,338,02338,0,0,0,37,0,3,0,0,0,26,0,0,140030,26,3,0,37,0
19,338,02339,0,0,0,22,0,10,0,0,0,28,0,0,160551,28,10,0,22,0
19,338,02340,18,0,0,5,0,2,0,0,0,181,0,0,285207,181,2,0,5,18
19,338,02341,0,0,0,13,0,17,0,0,0,347,0,0,173437,347,17,0,13,0
19,338,02342,0,0,0,30,0,16,0,0,0,68,0,0,179148,68,16,0,30,0
19,338,02343,4,0,0,22,0,6,0,0,0,100,0,0,320534,100,6,0,22,4
19,338,02344,0,1,35,66,2,16,6,6,0,50,9,35,316197,59,22,6,68,1
19,338,02345,3,0,0,101,0,73,4,0,9,117,8,0,228992,125,77,9,101,3
19,338,02346,0,1,8,7,16,9,15,6,0,34,27,25,244383,61,24,6,23,1
19,338,02347,15,0,0,36,0,20,0,0,0,187,0,0,263511,187,20,0,36,15
19,338,02348,7,0,0,121,0,122,0,0,6,153,0,0,261073,153,122,6,121,7
19,338,02349,5,2,64,36,23,25,6,2,1,97,1011,66,276369,1108,31,3,59,7
19,338,02350,0,2,36,21,32,3,8,7,0,23,27,36,152266,50,11,7,53,2
19,338,02351,1,0,0,16,6,11,8,0,0,52,16,24,179825,68,19,0,22,1
19,338,02352,1,1,3,79,31,51,13,2,12,94,300,9,158396,394,64,14,110,2
19,338,02353,4,1,10,27,2,11,1,1,0,65,1,10,221574,66,12,1,29,5
19,338,02354,3,0,0,16,0,9,0,0,0,71,0,0,254434,71,9,0,16,3
19,338,02355,0,0,0,4,0,1,0,0,0,42,0,0,184714,42,1,0,4,0
19,338,99999,0,9,1902.95890045166,0,761,0,189.0765933990479,137.7428569793701,0,0,215,2817.701488494873,1518352,215,189.0766,137.74286,761,9
19,339,02356,2,0,0,39,0,14,0,0,0,33,0,0,135965,33,14,0,39,2
19,339,02357,1,0,0,20,0,13,0,0,3,50,0,0,86168,50,13,3,20,1
19,339,02358,6,0,0,27,0,4,0,0,0,297,0,0,180926,297,4,0,27,6
19,339,02359,0,1,0,74,6,25,2,1,0,44,2,8,194824,46,27,1,80,1
19,339,02360,2,0,0,34,0,11,0,0,1,55,0,0,156381,55,11,1,34,2
19,339,02361,1,0,0,10,0,18,0,0,0,30,0,0,107525,30,18,0,10,1
19,339,02362,1,0,0,33,0,15,0,0,2,45,0,0,140620,45,15,2,33,1
19,339,02363,1,2,42,30,5,3,5,4,0,161,12,52,201917,173,8,4,35,3
19,339,02364,1,0,0,19,0,3,0,0,0,46,0,0,158599,46,3,0,19,1
19,339,02365,1,0,0,39,0,19,0,0,8,77,0,0,184003,77,19,8,39,1
19,339,02366,0,0,0,57,0,35,0,0,0,67,0,0,169749,67,35,0,57,0
19,339,02367,0,0,0,41,0,21,0,0,0,49,2,0,188724,51,21,0,41,0
19,339,02368,1,0,0,62,0,16,0,0,1,49,0,0,156920,49,16,1,62,1
19,339,02369,2,0,0,61,0,31,0,0,0,64,0,0,156701,64,31,0,61,2
19,339,02370,8,0,0,8,0,12,0,0,4,103,0,0,252856,103,12,4,8,8
19,339,02371,2,0,0,43,0,23,0,0,1,58,0,0,147826,58,23,1,43,2
19,339,02372,2,1,30,23,4,7,7,7,1,62,1,30,142867,63,14,8,27,3
19,339,02373,3,0,0,330,0,43,4,0,10,42,1,0,116929,43,47,10,330,3
19,339,02374,2,0,0,86,0,20,0,0,2,23,0,0,83816,23,20,2,86,2
19,339,02375,7,0,0,77,0,41,0,0,6,68,0,0,119022,68,41,6,77,7
19,339,02376,17,1,0,20,11,3,11,3,1,123,7,0,171255,130,14,4,31,18
19,339,02377,0,0,0,26,0,12,0,0,0,31,0,0,106694,31,12,0,26,0
19,339,99999,0,5,1206,0,356,0,140,124,0,0,261342,1336,234254,261342,140,124,356,5
19,340,02378,4,1,20,6,0,2,0,0,0,46,2,20,133310,48,2,0,6,5
19,340,02379,5,1,10,14,0,6,2,2,0,58,4,10,169448,62,8,2,14,6
19,340,02380,2,0,0,47,9,30,0,0,1,68,6,0,200597,74,30,1,56,2
19,340,02381,0,1,0,3,0,4,0,0,0,24,2,0,113696,26,4,0,3,1
19,340,02382,0,0,0,8,0,5,0,0,0,29,0,0,117692,29,5,0,8,0
19,340,02383,17,0,0,46,1,39,0,0,9,103,1,2,101332,104,39,9,47,17
19,340,02384,34,0,0,44,4,48,4,0,2,139,5,0,78515,144,52,2,48,34
19,340,02385,1,2,198,47,764,31,29,22,0,59,6,237,199973,65,60,22,811,3
19,340,02386,2,0,0,65,0,49,0,0,5,49,0,0,143557,49,49,5,65,2
19,340,02387,3,0,0,118,0,36,0,0,0,75,1,0,151188,76,36,0,118,3
19,340,02388,1,0,0,80,0,24,0,0,1,32,0,0,123774,32,24,1,80,1
19,340,02389,0,0,0,199,0,12,0,0,0,36,0,0,154705,36,12,0,199,0
19,340,02390,10,1,0,154,0,43,0,0,4,132,3,0,137065,135,43,4,154,11
19,340,02391,3,1,35,18,15,6,15,2,0,46,4,125,148156,50,21,2,33,4
19,340,02392,5,0,0,31,0,14,0,0,1,46,0,0,135523,46,14,1,31,5
19,340,02393,0,0,0,7,0,4,0,0,0,15,3,0,137912,18,4,0,7,0
19,340,02394,0,0,0,23,2,2,0,0,0,16,1,0,170425,17,2,0,25,0
19,340,02395,2,0,0,72,0,15,0,0,1,44,0,0,153861,44,15,1,72,2
19,340,02396,1,0,0,13,0,23,0,0,0,24,0,0,97164,24,23,0,13,1
19,340,02397,5,1,30,25,0,23,0,0,8,98,3,33,94897,101,23,8,25,6
19,340,99999,0,2,321,0,55,0,16,7,0,0,9,347,166172,9,16,7,55,2
19,341,02398,2,0,0,30,0,53,0,0,0,61,0,0,190186,61,53,0,30,2
19,341,02399,1,0,0,147,12,74,3,0,0,94,3,0,208132,97,77,0,159,1
19,341,02400,1,0,0,17,0,12,0,0,0,47,10,0,223158,57,12,0,17,1
19,341,02401,0,0,0,75,3,48,2,0,0,38,9,3,257941,47,50,0,78,0
19,341,02402,0,5,15,19,19,11,7,4,0,27,54,46,377588,81,18,4,38,5
19,341,02403,0,0,55.43801498413086,3,12,0,7.695636749267578,5.900826454162598,0,2,2,73.09376525878906,209504,4,7.6956367,5.9008265,15,0
19,341,02404,0,0,0,5,38,8,39,0,0,35,69,88,330828,104,47,0,43,0
19,341,02405,1,1,0,8,9,20,6,0,7,18,23,24,251930,41,26,7,17,2
19,341,02406,0,0,0,43,21,3,4,0,0,20,6,10,191599,26,7,0,64,0
19,341,02407,1,0,0,42,6,4,1,0,0,45,12,0,215392,57,5,0,48,1
19,341,02408,0,4,45,32,133,22,83,8,0,37,57,55,221500,94,105,8,165,4
19,341,02409,0,3,26,4,37,4,10,6,0,26,32,26,164405,58,14,6,41,3
19,341,02410,0,0,0,70,1,22,5,0,0,43,3,0,205849,46,27,0,71,0
19,341,02411,1,0,0,43,1,4,0,0,1,29,0,0,196164,29,4,1,44,1
19,341,99999,0,21,6622,0,37,0,735,696,0,0,4760,8544,1605793,4760,735,696,37,21
19,342,99999,0,48,15367,0,26,0,13,0,0,0,468,15480,4496694,468,13,0,26,48
19,343,02412,0,3,0,18,5,20,5,4,0,25,7,0,176203,32,25,4,23,3
19,343,02413,1,0,0,10,10,2,0,0,0,17,5,0,112908,22,2,0,20,1
19,343,02414,1,0,0,29,0,15,0,0,0,41,3,3,192134,44,15,0,29,1
19,343,02415,0,0,0,9,0,9,0,0,0,60,9,0,232365,69,9,0,9,0
19,343,02416,20,2,60,53,25,6,17,12,0,92,18,60,214531,110,23,12,78,22
19,343,02417,1,0,0,6,5,6,1,0,0,36,2,10,219863,38,7,0,11,1
19,343,02418,0,0,0,19,0,20,0,0,0,80,13,0,249170,93,20,0,19,0
19,343,02419,6,0,0,179,0,63,0,0,8,269,0,0,246708,269,63,8,179,6
19,343,02420,0,1,1000,23,4,9,3,0,0,53,23,1017,304724,76,12,0,27,1
19,343,02421,0,0,0,86,8,20,8,0,0,50,3,15,252523,53,28,0,94,0
19,343,02422,3,1,6,21,5,30,3,2,0,109,3049,6,433119,3158,33,2,26,4
19,343,02423,0,0,0,37,3,16,3,0,0,11,6,1,304744,17,19,0,40,0
19,343,02424,1,1,0,72,6,40,5,3,0,62,10,4,268038,72,45,3,78,2
19,343,02425,0,0,0,32,1,8,3,0,0,417,41,0,249518,458,11,0,33,0
19,343,02426,0,0,0,32,0,29,0,0,0,49,0,0,155877,49,29,0,32,0
19,343,02427,2,0,0,89,2,41,0,0,2,59,1,0,182491,60,41,2,91,2
19,343,02428,2,0,0,28,0,16,0,0,2,80,6,0,283139,86,16,2,28,2
19,343,02429,6,0,0,78,0,9,0,0,0,94,13,2,203064,107,9,0,78,6
19,343,02430,3,2,0,54,0,13,3,2,2,141,3,0,195104,144,16,4,54,5
19,343,02431,1,0,0,105,12,26,14,0,8,55,94,34,263151,149,40,8,117,1
19,343,02432,1,0,0,4,0,12,6,0,0,51,1,6,252164,52,18,0,4,1
19,343,02433,0,0,0,79,0,16,0,0,0,52,0,0,229053,52,16,0,79,0
19,343,02434,1,0,0,37,0,28,0,0,0,72,0,0,336717,72,28,0,37,1
19,343,02435,1,0,0,63,0,29,0,0,0,92,0,0,246598,92,29,0,63,1
19,343,02436,2,0,0,20,0,2,0,0,0,71,0,0,220839,71,2,0,20,2
19,343,02437,1,0,0,72,0,11,0,0,0,90,0,0,281963,90,11,0,72,1
19,343,02438,3,0,0,14,0,20,0,0,1,739,0,0,212037,739,20,1,14,3
19,343,02439,1,0,0,35,0,7,0,0,0,47,0,0,182830,47,7,0,35,1
19,343,02440,3,0,0,27,0,20,0,0,4,131,0,0,331823,131,20,4,27,3
19,343,99999,0,4,339.6636362075806,0,50,0,70.35857558250427,44.609090924263,0,0,93,350.7453603744507,1107421,93,70.358574,44.609093,50,4
19,344,02441,1,1,0,103,7,99,1,1,1,62,1,0,163905,63,100,2,110,2
19,344,02442,2,0,0,60,0,45,0,0,8,187,0,0,154832,187,45,8,60,2
19,344,02443,0,0,0,24,0,2,0,0,0,30,0,0,148261,30,2,0,24,0
19,344,02444,3,0,0,125,0,59,0,0,2,95,935,0,228078,1030,59,2,125,3
19,344,02445,0,1,19,94,17,32,4,4,0,142,3,19,169203,145,36,4,111,1
19,344,02446,2,0,0,44,0,46,0,0,16,81,0,0,136006,81,46,16,44,2
19,344,02447,25,0,0,58,0,58,0,0,18,176,0,0,123219,176,58,18,58,25
19,344,02448,1,0,0,50,0,26,0,0,2,54,0,0,219555,54,26,2,50,1
19,344,02449,0,0,0,18,0,14,0,0,0,27,0,0,203436,27,14,0,18,0
19,344,02450,0,0,0,54,0,23,0,0,0,70,0,0,238110,70,23,0,54,0
19,344,02451,18,0,0,51,0,52,0,0,2,217,0,0,338261,217,52,2,51,18
19,344,02452,1,0,0,20,0,24,0,0,0,80,0,0,187711,80,24,0,20,1
19,344,02453,11,0,0,51,0,38,0,0,0,149,0,0,191487,149,38,0,51,11
19,344,02454,0,0,0,74,0,34,0,0,0,76,0,0,168971,76,34,0,74,0
19,344,02455,3,0,0,42,0,32,0,0,8,66,0,0,112484,66,32,8,42,3
19,344,02456,4,0,0,22,0,6,0,0,0,59,0,0,104947,59,6,0,22,4
19,344,02457,3,0,0,108,0,34,0,0,3,71,0,0,108123,71,34,3,108,3
19,344,02458,1,0,0,9,0,10,0,0,0,40,0,0,141781,40,10,0,9,1
19,344,02459,0,0,0,14,0,9,0,0,0,30,0,0,115317,30,9,0,14,0
19,344,02460,0,1,394,14,0,18,0,0,0,53,2,394,257797,55,18,0,14,1
19,344,02461,7,0,0,32,0,18,0,0,0,98,0,0,183024,98,18,0,32,7
19,344,02462,15,0,0,85,13,65,2,0,8,263,4,20,288170,267,67,8,98,15
19,344,02463,1,0,0,57,0,28,0,0,0,100,0,0,194620,100,28,0,57,1
19,344,02464,1,0,0,39,0,35,0,0,0,71,0,0,270491,71,35,0,39,1
19,344,02465,11,1,25,114,0,51,9,6,5,399,3,25,302278,402,60,11,114,12
19,344,02466,3,0,0,49,0,26,0,0,6,54,0,0,149162,54,26,6,49,3
19,344,02467,9,0,0,51,0,14,0,0,3,50,5,0,171903,55,14,3,51,9
19,344,02468,7,0,0,43,0,22,0,0,3,109,0,0,155017,109,22,3,43,7
19,344,02469,1,0,0,71,0,10,0,0,3,30,0,0,111858,30,10,3,71,1
19,344,99999,0,11,1706,0,113,0,79,73,0,0,227,2017,564913,227,79,73,113,11
19,345,02470,4,0,0,216,0,107,0,0,7,443,0,0,283303,443,107,7,216,4
19,345,02471,1,1,15,105,65,28,10,4,2,185,20,80,284423,205,38,6,170,2
19,345,02472,0,1,30,31,13,19,4,4,0,138,1,30,217771,139,23,4,44,1
19,345,02473,1,0,0,25,7,39,6,0,1,82,8,80,199166,90,45,1,32,1
19,345,02474,1,0,0,46,0,25,0,0,1,73,0,0,243423,73,25,1,46,1
19,345,02475,1,0,0,52,13,49,3,0,8,146,4,25,203644,150,52,8,65,1
19,345,02476,2,0,0,128,0,16,0,0,4,86,0,0,220037,86,16,4,128,2
19,345,02477,5,0,0,40,0,23,0,0,5,96,0,0,173316,96,23,5,40,5
19,345,02478,0,0,0,9,0,23,0,0,0,22,0,0,175008,22,23,0,9,0
19,345,02479,2,0,0,26,0,10,0,0,0,537,0,0,191996,537,10,0,26,2
19,345,02480,0,0,0,2,6,3,7,0,0,23,7,0,234285,30,10,0,8,0
19,345,02481,2,1,25,18,2,4,6,4,0,55,4,25,188032,59,10,4,20,3
19,345,02482,6,0,0,71,0,42,1,0,0,84,1,0,123784,85,43,0,71,6
19,345,02483,0,0,0,8,0,18,0,0,0,18,0,0,97992,18,18,0,8,0
19,345,02484,0,1,15,14,1,15,6,4,0,41,2,25,207827,43,21,4,15,1
19,345,02485,1,0,0,1,0,17,0,0,1,39,3,0,123175,42,17,1,1,1
19,345,02486,0,0,0,6,0,5,0,0,0,24,0,0,132992,24,5,0,6,0
19,345,02487,11,0,0,0,0,18,0,0,0,71,0,0,139365,71,18,0,0,11
19,345,02488,3,0,0,29,0,29,0,0,1,144,0,0,170752,144,29,1,29,3
19,345,02489,1,1,10,37,3,8,3,3,0,61,2,10,175271,63,11,3,40,2
19,345,02490,3,0,0,39,0,19,0,0,3,144,0,0,156702,144,19,3,39,3
19,345,02491,1,0,0,32,0,21,0,0,0,46,0,0,167116,46,21,0,32,1
19,345,02492,4,0,0,106,0,14,0,0,6,64,0,0,178652,64,14,6,106,4
19,345,02493,3,1,15,43,4,3,1,1,0,69,1,15,167219,70,4,1,47,4
19,345,02494,2,0,0,55,0,14,0,0,0,45,0,0,155954,45,14,0,55,2
19,345,99999,0,11,209,0,145,0,112,88,0,0,95,209,446439,95,112,88,145,11
20,346,02495,1,0,0,21,0,13,0,0,1,12,0,0,51479,12,13,1,21,1
20,346,02496,0,2,4,51,2,34,1,1,0,56,2,4,85319,58,35,1,53,2
20,346,02497,6,0,0,23,0,23,0,0,6,19,0,0,50785,19,23,6,23,6
20,346,02498,1,0,0,38,0,28,0,0,1,16,0,0,81470,16,28,1,38,1
20,346,02499,0,1,3,6,3,3,5,1,0,6,551,11,70899,557,8,1,9,1
20,346,02500,13,0,0,111,0,96,0,0,13,80,0,0,37930,80,96,13,111,13
20,346,02501,1,0,0,23,0,11,0,0,1,13,0,0,70571,13,11,1,23,1
20,346,02502,0,0,0,9,0,4,0,0,0,45,0,0,32168,45,4,0,9,0
20,346,02503,1,0,0,23,0,8,0,0,1,43,0,0,102697,43,8,1,23,1
20,346,02504,1,0,0,12,0,5,0,0,1,12,0,0,55434,12,5,1,12,1
20,346,02505,0,0,0,6,0,1,0,0,0,3,0,0,30396,3,1,0,6,0
20,346,02506,0,0,0,6,0,2,0,0,0,6,0,0,63665,6,2,0,6,0
20,346,02507,0,0,0,18,0,8,0,0,0,10,0,0,38833,10,8,0,18,0
20,346,02508,1,0,0,38,0,13,0,0,1,33,0,0,130237,33,13,1,38,1
20,346,02509,3,1,56,61,63,31,34,5,6,41,18,313,201586,59,65,11,124,4
20,346,02510,0,0,0,6,0,3,0,0,0,8,0,0,17856,8,3,0,6,0
20,346,02511,1,0,0,19,0,9,0,0,1,12,0,0,90481,12,9,1,19,1
20,346,02512,0,0,0,4,0,1,0,0,0,3,0,0,44452,3,1,0,4,0
20,346,02513,1,0,0,21,0,11,0,0,1,14,0,0,66017,14,11,1,21,1
20,347,02514,11,0,0,127,0,106,0,0,10,102,0,0,187311,102,106,10,127,11
20,347,02515,2,0,0,47,0,26,0,0,4,20,0,0,119917,20,26,4,47,2
20,347,02516,1,0,0,9,0,8,0,0,1,5,0,0,29896,5,8,1,9,1
20,347,02517,3,0,0,31,0,19,0,0,2,20,0,0,50246,20,19,2,31,3
20,347,02518,5,1,30,45,27,31,11,5,5,29,121,60,150726,150,42,10,72,6
20,347,02519,2,0,0,24,0,14,0,0,2,17,0,0,62736,17,14,2,24,2
20,347,02520,6,0,0,105,0,77,0,0,7,56,0,0,74679,56,77,7,105,6
20,347,02521,3,0,0,202,0,123,0,0,3,71,0,0,58708,71,123,3,202,3
20,347,02522,1,0,0,21,0,11,0,0,1,37,0,0,40896,37,11,1,21,1
20,347,02523,1,0,0,4,0,1,0,0,1,5,0,0,31530,5,1,1,4,1
20,347,02524,12,0,0,71,0,132,0,0,21,63,0,0,107762,63,132,21,71,12
20,347,02525,1,1,30,21,58,6,9,9,1,11,1,30,126281,12,15,10,79,2
20,348,02526,15,0,0,592,0,344,0,0,26,169,0,0,74318,169,344,26,592,15
20,348,02527,3,4,106,20,108,12,53,7,2,78,384,239,205706,462,65,9,128,7
20,348,02528,4,1,4,38,2,31,1,1,4,66,5,4,125349,71,32,5,40,5
20,348,02529,9,0,0,52,0,46,0,0,9,94,0,0,131194,94,46,9,52,9
20,348,02530,5,0,0,21,0,25,0,0,8,26,0,0,84837,26,25,8,21,5
20,348,02531,3,0,0,30,0,19,0,0,3,89,0,0,94365,89,19,3,30,3
20,349,02532,2,0,0,29,0,35,0,0,2,39,0,0,115811,39,35,2,29,2
20,349,02533,0,0,0,33,0,11,0,0,0,37,0,0,94777,37,11,0,33,0
20,349,02534,6,0,0,52,0,49,0,0,6,51,0,0,182192,51,49,6,52,6
20,349,02535,5,1,30,88,58,52,6,6,5,64,9,30,267303,73,58,11,146,6
20,349,02536,9,0,0,45,0,32,0,0,9,48,0,0,271325,48,32,9,45,9
20,349,02537,2,0,0,28,0,23,0,0,2,21,0,0,152917,21,23,2,28,2
20,349,02538,2,0,0,23,0,15,0,0,2,25,0,0,174985,25,15,2,23,2
20,349,02539,3,3,122,64,476,58,191,25,3,56,1632,275,372329,1688,249,28,540,6
20,349,02540,3,0,0,32,0,19,0,0,3,30,0,0,169392,30,19,3,32,3
20,349,02541,1,0,0,18,0,13,0,0,1,21,0,0,158079,21,13,1,18,1
20,349,02542,0,1,50,29,3,17,3,1,0,19,15,54,149068,34,20,1,32,1
20,349,02543,5,3,36,63,57,52,6,6,5,37,25,140,225860,62,58,11,120,8
20,349,02544,1,0,0,32,0,10,0,0,1,29,0,0,109302,29,10,1,32,1
20,350,02545,0,3,189,19,75,10,20,15,0,34,1134,332,345735,1168,30,15,94,3
20,350,02546,0,0,0,25,0,9,0,0,0,128,0,0,174888,128,9,0,25,0
20,350,02547,1,0,0,4,0,6,0,0,0,38,0,0,90482,38,6,0,4,1
20,350,02548,1,0,0,4,0,28,0,0,2,35,0,0,75880,35,28,2,4,1
20,350,02549,2,0,0,13,0,15,0,0,0,59,0,0,106707,59,15,0,13,2
20,350,02550,11,3,32,41,23,11,12,8,1,139,31,62,190383,170,23,9,64,14
20,350,02551,0,0,0,4,0,1,0,0,0,20,0,0,86589,20,1,0,4,0
20,350,02552,3,0,0,28,0,9,0,0,1,33,0,0,88116,33,9,1,28,3
20,350,02553,2,0,0,13,0,2,0,0,0,100,0,0,168561,100,2,0,13,2
20,350,02554,1,0,0,20,0,8,0,0,0,30,0,0,161105,30,8,0,20,1
20,351,02555,6,0,0,53,0,40,0,0,6,39,0,0,146146,39,40,6,53,6
20,351,02556,0,0,0,10,0,4,0,0,0,10,0,0,99403,10,4,0,10,0
20,351,02557,3,0,0,94,0,47,0,0,3,53,0,0,136974,53,47,3,94,3
20,351,02558,3,1,30,25,41,17,5,5,3,20,6721,30,196546,6741,22,8,66,4
20,351,02559,2,0,0,34,0,19,0,0,2,27,0,0,115436,27,19,2,34,2
20,351,02560,8,0,0,85,0,57,0,0,8,66,0,0,93386,66,57,8,85,8
20,351,02561,2,3,70,35,24,14,8,6,2,30,245,78,270108,275,22,8,59,5
20,351,02562,6,0,0,70,0,58,0,0,7,56,0,0,187434,56,58,7,70,6
20,351,02563,2,0,0,18,0,8,0,0,2,14,0,0,64608,14,8,2,18,2
20,352,02564,0,1,100,5,63,3,26,10,0,6,120,162,162081,126,29,10,68,1
20,352,02565,2,0,0,45,0,25,0,0,2,69,0,0,74657,69,25,2,45,2
20,352,02566,5,1,5,23,18,13,5,5,4,55,6,5,96640,61,18,9,41,6
20,352,02567,0,1,20,9,22,4,7,5,0,183,1,28,129676,184,11,5,31,1
20,352,02568,1,0,0,22,0,13,0,0,1,25,0,0,75376,25,13,1,22,1
20,352,02569,3,2,34,13,13,6,5,2,3,27,64,69,168226,91,11,5,26,5
20,352,02570,3,1,6,18,7,9,1,1,3,36,6,6,177204,42,10,4,25,4
20,352,02571,3,0,0,38,0,25,0,0,3,35,0,0,81570,35,25,3,38,3
20,352,02572,0,0,0,33,0,12,0,0,0,43,0,0,180718,43,12,0,33,0
20,353,02573,6,0,0,78,0,38,0,0,9,47,0,0,105313,47,38,9,78,6
20,353,02574,4,0,0,79,0,62,0,0,5,46,0,0,64991,46,62,5,79,4
20,353,02575,1,0,0,22,0,6,0,0,1,17,0,0,83993,17,6,1,22,1
20,353,02576,0,1,26,26,35,19,5,5,0,22,311,83,327843,333,24,5,61,1
20,353,02577,5,0,0,65,0,31,0,0,5,39,0,0,208617,39,31,5,65,5
20,353,02578,1,0,0,25,0,16,0,0,1,16,0,0,108511,16,16,1,25,1
20,354,02579,1,0,0,26,0,16,0,0,1,32,0,0,101663,32,16,1,26,1
20,354,02580,0,0,0,8,0,6,0,0,0,5,0,0,50198,5,6,0,8,0
20,354,02581,3,2,36,58,14,31,5,3,3,33,15,42,163312,48,36,6,72,5
20,354,02582,7,2,2,77,87,62,79,14,8,65,23,27,334187,88,141,22,164,9
20,354,02583,2,0,0,36,4,13,4,0,2,31,12,10,245502,43,17,2,40,2
20,354,02584,0,15,1279,14,212,5,240,211,0,9,204,1652,1221343,213,245,211,226,15
20,354,02586,0,1,6,28,6,12,3,3,0,23,4818,8,140908,4841,15,3,34,1
20,354,02587,9,8,301,147,103,76,36,15,9,76,132,458,426541,208,112,24,250,17
20,355,02588,1,0,0,11,4,10,2,0,1,11,1,4,138434,12,12,1,15,1
20,355,02589,0,2,39,12,7,4,4,2,0,12,12,58,132162,24,8,2,19,2
20,355,02590,1,8,223,4,292,4,56,39,1,4,97,243,189777,101,60,40,296,9
20,355,02591,5,3,175,60,70,46,34,14,5,39,14,246,231133,53,80,19,130,8
20,355,02592,2,0,0,65,0,57,0,0,2,35,0,0,132150,35,57,2,65,2
20,355,02593,1,0,0,74,0,22,0,0,1,36,0,0,89965,36,22,1,74,1
20,355,02594,1,2,30,7,25,3,19,6,1,9,10,120,104954,19,22,7,32,3
20,355,02595,2,9,1230,28,1285,17,265,205,2,28,165,1492,813365,193,282,207,1313,11
20,355,02596,4,1,3,26,1,16,2,1,4,25,6,3,230211,31,18,5,27,5
20,356,02597,5,0,0,56,0,51,0,0,4,30,0,0,54959,30,51,4,56,5
20,356,02598,1,0,0,13,0,3,0,0,0,8,0,0,31057,8,3,0,13,1
20,356,02599,5,0,0,56,0,19,0,0,5,29,0,0,84786,29,19,5,56,5
20,356,02600,1,0,0,11,0,4,0,0,1,14,0,0,37867,14,4,1,11,1
20,356,02601,1,3,125,55,45,17,15,6,1,37,47,233,126009,84,32,7,100,4
20,356,02602,1,0,0,16,0,3,0,0,0,17,0,0,69768,17,3,0,16,1
20,356,02603,8,0,0,69,0,46,0,0,13,52,0,0,57303,52,46,13,69,8
20,357,02604,2,0,0,36,0,16,0,0,2,17,0,0,82841,17,16,2,36,2
20,357,02605,0,0,0,14,0,5,0,0,0,11,0,0,68983,11,5,0,14,0
20,357,02606,2,30,1270,21,566,14,96,70,2,19,8550,3357,1260159,8569,110,72,587,32
20,357,02607,0,1,70,58,2,32,1,1,0,37,24,115,129654,61,33,1,60,1
20,357,02608,0,1,10,57,30,21,15,2,0,42,21,34,199456,63,36,2,87,1
20,357,02609,0,2,220,1,11,1,6,6,0,0,10,223,107080,10,7,6,12,2
20,357,02610,1,0,0,26,0,15,0,0,1,10,0,0,62128,10,15,1,26,1
20,357,02611,0,0,0,43,0,25,0,0,0,29,0,0,61795,29,25,0,43,0
20,357,02612,0,0,0,7,0,4,0,0,0,5,0,0,42967,5,4,0,7,0
20,357,02613,0,3,43,10,57,2,4,3,0,6,44,53,124661,50,6,3,67,3
20,357,02614,4,0,0,27,0,20,0,0,4,21,0,0,152121,21,20,4,27,4
20,358,02615,2,1,30,69,15,60,5,4,2,32,68,42,162163,100,65,6,84,3
20,358,02616,5,0,0,34,0,33,0,0,7,13,0,0,74005,13,33,7,34,5
20,358,02617,1,0,0,7,0,5,0,0,1,4,0,0,47248,4,5,1,7,1
20,358,02618,2,0,0,7,0,4,1,0,2,6,1,0,73978,7,5,2,7,2
20,358,02619,0,0,0,5,0,1,0,0,0,3,0,0,36257,3,1,0,5,0
20,358,02620,2,0,0,57,0,42,0,0,2,49,0,0,147348,49,42,2,57,2
20,358,02621,1,0,0,5,0,42,0,0,1,13,0,0,73616,13,42,1,5,1
20,358,02622,1,0,0,12,0,10,0,0,1,6,0,0,67886,6,10,1,12,1
20,358,02623,0,0,0,2,0,1,0,0,0,3,0,0,38888,3,1,0,2,0
20,358,02624,0,0,0,19,35,16,2,0,0,15,13,6,104955,28,18,0,54,0
20,358,02625,0,0,0,6,0,5,0,0,0,13,0,0,50109,13,5,0,6,0
20,358,02626,3,0,0,20,0,13,0,0,3,15,0,0,134402,15,13,3,20,3
20,358,02627,1,0,0,13,0,8,0,0,1,11,0,0,46922,11,8,1,13,1
20,358,02628,5,0,0,7,0,8,0,0,5,7,0,0,46724,7,8,5,7,5
20,358,02629,1,0,0,13,0,10,0,0,1,15,0,0,81201,15,10,1,13,1
20,358,02630,3,0,0,20,0,11,0,0,2,17,0,0,157512,17,11,2,20,3
20,358,02631,3,0,0,24,0,13,0,0,3,11,0,0,66399,11,13,3,24,3
20,358,02632,6,0,0,40,0,26,0,0,6,31,0,0,100077,31,26,6,40,6
20,358,02633,0,4,110,15,133,7,28,12,0,12,76,135,201583,88,35,12,148,4
20,358,02634,4,1,2,34,1,23,1,1,4,33,2,4,226382,35,24,5,35,5
20,359,02635,1,0,0,15,0,5,0,0,1,16,0,0,88059,16,5,1,15,1
20,359,02636,5,1,6,42,3,26,1,1,5,31,4,6,98988,35,27,6,45,6
20,359,02637,4,0,0,35,0,25,0,0,3,41,0,0,74693,41,25,3,35,4
20,359,02638,2,0,0,44,0,37,0,0,2,8,0,0,30196,8,37,2,44,2
20,359,02639,0,1,100,34,137,4,48,2,0,26,31,206,144249,57,52,2,171,1
20,359,02640,1,0,0,14,0,3,0,0,0,13,0,0,88905,13,3,0,14,1
20,359,02641,0,0,0,11,0,5,0,0,0,11,0,0,60095,11,5,0,11,0
20,359,02642,0,0,0,4,0,4,0,0,0,5,0,0,34588,5,4,0,4,0
20,359,02643,0,1,5,23,2,5,1,1,0,22,3,5,106609,25,6,1,25,1
20,360,02644,5,1,6,31,21,24,4,4,4,26,21,12,161476,47,28,8,52,6
20,360,02645,3,2,12,36,17,18,4,4,3,38,17,12,131532,55,22,7,53,5
20,360,02646,0,0,0,10,0,2,0,0,0,16,0,0,56014,16,2,0,10,0
20,360,02647,1,0,0,20,0,7,0,0,1,26,0,0,112740,26,7,1,20,1
20,360,02648,0,0,0,6,0,1,0,0,0,6,0,0,48516,6,1,0,6,0
20,360,02649,0,0,0,8,0,8,0,0,0,9,0,0,52259,9,8,0,8,0
20,360,02650,0,0,0,11,0,12,0,0,0,13,0,0,122165,13,12,0,11,0
20,360,02651,0,0,0,11,0,4,0,0,0,11,0,0,52050,11,4,0,11,0
20,360,02652,3,1,6,22,51,12,8,4,2,22,5,30,156431,27,20,6,73,4
20,360,02653,0,6,221,22,11,8,49,46,0,15,48,425,290064,63,57,46,33,6
20,360,02654,1,1,1,12,2,3,1,1,0,11,1,1,108343,12,4,1,14,2
20,360,02655,1,0,0,7,0,4,0,0,1,8,1,0,82385,9,4,1,7,1
20,360,02656,3,0,0,26,0,25,0,0,4,25,0,0,91357,25,25,4,26,3
20,360,02657,4,0,0,42,0,40,0,0,3,33,0,0,136828,33,40,3,42,4
20,360,02658,3,0,0,15,3,22,3,0,2,16,28,25,53705,44,25,2,18,3
20,360,02659,0,1,20,4,80,0,12,9,0,4,4,31,77736,8,12,9,84,1
20,361,02660,1,13,333,22,51,5,17,11,1,18,19,338,247841,37,22,12,73,14
20,361,02661,3,12,202,38,138,13,57,30,3,25,74,414,253025,99,70,33,176,15
20,361,02662,0,7,418,12,432,2,129,66,0,10,54,667,161821,64,131,66,444,7
20,361,02663,1,0,0,22,0,2,0,0,1,22,0,0,66233,22,2,1,22,1
20,361,02664,0,1,50,5,16,2,21,10,0,6,5,60,70701,11,23,10,21,1
20,361,02665,0,0,0,32,0,9,0,0,0,33,0,0,149784,33,9,0,32,0
20,362,02666,3,0,0,72,0,14,0,0,3,46,0,0,156138,46,14,3,72,3
20,362,02667,3,3,30,138,23,34,6,3,3,70,19,40,184510,89,40,6,161,6
20,362,02668,5,0,0,78,0,37,0,0,9,47,0,0,159789,47,37,9,78,5
20,362,02669,5,0,0,32,0,15,0,0,4,28,0,0,41965,28,15,4,32,5
20,362,02670,1,0,0,43,0,11,0,0,1,25,0,0,71400,25,11,1,43,1
20,362,02671,2,0,0,55,0,15,0,0,2,40,0,0,131082,40,15,2,55,2
20,362,02672,2,0,0,56,0,8,0,0,2,40,0,0,101536,40,8,2,56,2
20,362,02673,0,7,156,43,148,8,128,47,0,23,78,264,210666,101,136,47,191,7
20,362,02674,11,0,0,182,0,86,0,0,11,105,0,0,137884,105,86,11,182,11
20,362,02675,3,0,0,32,0,10,0,0,3,18,0,0,124482,18,10,3,32,3
20,363,02676,3,0,0,248,0,272,0,0,3,264,0,0,163697,264,272,3,248,3
20,363,02677,0,1,6,25,8,21,3,2,0,46,4427,6,115119,4473,24,2,33,1
20,363,02678,2,3,40,44,61,19,14,7,2,31,55,194,202413,86,33,9,105,5
20,363,02679,1,0,0,19,0,12,0,0,1,25,0,0,134551,25,12,1,19,1
20,363,02680,0,0,0,19,0,6,0,0,0,19,0,0,89467,19,6,0,19,0
20,363,02681,0,0,0,18,0,9,0,0,0,42,0,0,84842,42,9,0,18,0
20,364,02682,8,0,0,66,0,44,0,0,8,39,0,0,89889,39,44,8,66,8
20,364,02683,1,2,102,48,19,21,4,2,1,11,18,102,78219,29,25,3,67,3
20,364,02684,2,16,2705,50,1940,23,450,430,2,49,100,2839,1317499,149,473,432,1990,18
20,364,02685,4,1,250,34,304,22,64,58,4,29,4,250,94137,33,86,62,338,5
20,364,02686,15,0,0,79,0,46,0,0,12,60,0,0,112759,60,46,12,79,15
20,364,02687,0,0,0,9,0,4,0,0,0,6,0,0,53916,6,4,0,9,0
20,364,02688,5,1,20,40,2,24,1,1,5,37,5,20,113749,42,25,6,42,6
20,364,02689,2,0,0,29,0,20,0,0,2,29,0,0,77252,29,20,2,29,2
20,364,02690,3,3,15,39,3,11,1,1,3,61,11,15,145816,72,12,4,42,6
20,364,02691,1,0,0,27,0,21,0,0,0,24,9,0,76565,33,21,0,27,1
20,364,02692,0,0,0,26,8,15,0,0,0,21,2,1,76442,23,15,0,34,0
20,364,02693,1,0,0,53,0,35,0,0,1,39,0,0,128585,39,35,1,53,1
20,364,02694,5,0,0,71,0,38,0,0,4,50,0,0,107503,50,38,4,71,5
20,364,02695,1,0,0,27,0,25,0,0,6,20,0,0,113090,20,25,6,27,1
20,364,02696,1,0,0,9,0,6,0,0,0,28,0,0,50058,28,6,0,9,1
20,364,02697,7,0,0,46,0,26,0,0,10,83,0,0,63053,83,26,10,46,7
20,364,02698,0,1,30,15,12,1,7,7,0,42,10,34,82942,52,8,7,27,1
20,364,02699,1,0,0,52,0,18,0,0,1,64,0,0,132672,64,18,1,52,1
20,365,02700,8,0,0,72,0,39,0,0,8,51,0,0,109082,51,39,8,72,8
20,365,02701,6,5,30,26,47,12,3,3,6,26,6,30,92991,32,15,9,73,11
20,365,02702,4,0,0,41,0,21,0,0,4,28,0,0,39340,28,21,4,41,4
20,365,02703,7,0,0,30,0,18,0,0,7,28,0,0,85429,28,18,7,30,7
20,365,02704,7,2,30,113,40,86,9,5,7,36,17,42,124218,53,95,12,153,9
20,365,02705,7,0,0,29,0,15,0,0,7,26,0,0,80465,26,15,7,29,7
20,366,02706,4,0,0,74,0,23,0,0,4,25,0,0,62319,25,23,4,74,4
20,366,02707,2,0,0,65,0,27,0,0,2,32,0,0,114399,32,27,2,65,2
20,366,02708,2,0,0,64,0,34,0,0,2,34,0,0,116844,34,34,2,64,2
20,366,02709,3,0,0,36,0,15,0,0,2,28,0,0,84572,28,15,2,36,3
20,366,02710,3,0,0,58,0,55,0,0,3,30,0,0,63775,30,55,3,58,3
20,366,02711,5,0,0,132,0,86,0,0,5,47,0,0,80731,47,86,5,132,5
20,366,02712,0,2,100,77,39,19,12,10,0,42,861,117,213594,903,31,10,116,2
20,366,02713,6,0,0,83,0,48,0,0,8,40,0,0,56591,40,48,8,83,6
20,366,02714,0,0,0,43,0,16,0,0,0,21,0,0,49093,21,16,0,43,0
20,366,02715,4,0,0,7,0,6,0,0,4,6,0,0,30926,6,6,4,7,4
20,366,02716,10,0,0,89,0,22,0,0,10,54,0,0,71443,54,22,10,89,10
20,366,02717,2,0,0,49,0,26,0,0,2,44,0,0,80859,44,26,2,49,2
20,367,02718,0,1,92,38,56,19,12,8,0,48,21076,105,115075,21124,31,8,94,1
20,367,02719,0,0,0,24,0,4,0,0,0,20,0,0,37507,20,4,0,24,0
20,367,02720,1,0,0,39,0,10,0,0,1,23,0,0,47984,23,10,1,39,1
20,367,02721,1,0,0,27,0,12,0,0,1,23,0,0,39218,23,12,1,27,1
20,367,02722,1,0,0,38,0,13,0,0,2,45,0,0,30786,45,13,2,38,1
20,367,02723,2,0,0,51,0,18,0,0,2,59,0,0,87458,59,18,2,51,2
20,367,02724,5,0,0,37,0,15,0,0,5,53,0,0,71283,53,15,5,37,5
20,367,02725,3,0,0,32,0,14,0,0,3,41,0,0,64286,41,14,3,32,3
20,367,02726,1,0,0,15,0,4,0,0,1,14,0,0,25519,14,4,1,15,1
20,367,02727,4,0,0,60,0,36,0,0,4,96,0,0,80462,96,36,4,60,4
20,368,02728,1,0,0,197,0,30,0,0,1,87,0,0,77628,87,30,1,197,1
20,368,02729,2,0,0,197,0,8,0,0,2,76,0,0,38247,76,8,2,197,2
20,368,02730,6,0,0,498,0,55,0,0,6,175,0,0,86953,175,55,6,498,6
20,368,02731,10,4,150,476,74,90,8,5,10,236,44,183,197849,280,98,15,550,14
20,368,02732,2,0,0,232,0,16,0,0,2,93,0,0,83047,93,16,2,232,2
20,368,02733,3,0,0,288,0,31,0,0,3,115,0,0,74019,115,31,3,288,3
20,368,02734,0,0,0,188,0,5,0,0,0,63,0,0,44390,63,5,0,188,0
20,368,02735,3,1,4,242,2,31,9,1,3,87,6,4,90142,93,40,4,244,4
20,368,02736,0,7,376,196,165,42,48,32,0,69,28,412,113333,97,90,32,361,7
20,368,02737,2,0,0,148,0,15,0,0,2,63,0,0,59918,63,15,2,148,2
20,368,02738,1,0,0,127,0,23,0,0,1,45,0,0,67226,45,23,1,127,1
20,368,02739,1,2,140,136,51,12,16,16,1,48,43,184,155954,91,28,17,187,3
20,368,02740,1,0,0,196,0,11,0,0,1,82,0,0,63910,82,11,1,196,1
20,368,02741,0,0,0,141,0,1,0,0,0,49,0,0,68450,49,1,0,141,0
20,368,02742,0,1,35,54,14,9,4,1,0,17,5,41,53792,22,13,1,68,1
20,368,02743,2,2,12,146,16,4,11,3,2,61,2,21,99133,63,15,5,162,4
20,368,02744,1,0,0,115,0,12,0,0,1,60,0,0,55266,60,12,1,115,1
20,368,02745,4,0,0,160,0,29,0,0,4,68,0,0,72616,68,29,4,160,4
20,369,02746,1,0,0,63,0,47,0,0,3,56,0,0,64250,56,47,3,63,1
20,369,02747,2,0,0,28,0,19,0,0,2,77,0,0,88642,77,19,2,28,2
20,369,02748,6,4,12,45,10,36,30,1,8,59,19,40,157855,78,66,9,55,10
20,369,02749,0,0,0,22,0,5,0,0,0,18,0,0,83091,18,5,0,22,0
20,369,02750,0,0,0,3,0,1,0,0,0,23,0,0,52971,23,1,0,3,0
20,369,02751,6,0,0,93,0,41,0,0,8,83,0,0,78639,83,41,8,93,6
20,369,02752,3,4,76,23,12,10,35,21,3,102,96,144,308839,198,45,24,35,7
20,369,02753,2,3,105,16,36,11,19,10,3,71,17,159,93660,88,30,13,52,5
20,369,02754,7,0,0,124,0,101,0,0,7,45,0,0,136523,45,101,7,124,7
21,370,02755,0,0,0,26,0,5,0,0,0,21,0,0,91916,21,5,0,26,0
21,370,02756,0,0,0,22,0,8,0,0,0,16,0,0,103676,16,8,0,22,0
21,370,02757,0,1,30,6,22,0,12,8,0,6,4,50,81178,10,12,8,28,1
21,370,02758,0,0,0,18,0,8,0,0,0,11,0,0,33259,11,8,0,18,0
21,370,02759,1,0,0,34,0,13,0,0,6,22,0,0,77443,22,13,6,34,1
21,370,02760,0,0,0,19,0,4,0,0,0,15,0,0,70239,15,4,0,19,0
21,370,02761,0,1,30,12,44,0,15,4,0,12,24,51,104566,36,15,4,56,1
21,370,02762,0,1,16,18,30,2,7,2,0,22,3,34,107374,25,9,2,48,1
21,370,02763,0,1,30,22,13,3,6,5,0,19,1,37,128271,20,9,5,35,1
21,370,02764,0,0,0,31,0,9,0,0,0,52,0,0,127399,52,9,0,31,0
21,370,02765,0,1,91,15,77,3,7,1,0,9,16,137,164131,25,10,1,92,1
21,370,02766,0,0,0,10,0,0,0,0,0,14,0,0,78389,14,0,0,10,0
21,370,02767,0,0,0,17,24,0,5,0,0,17,4,6,90321,21,5,0,41,0
21,370,02768,0,0,0,17,0,4,0,0,0,18,0,0,65680,18,4,0,17,0
21,370,02769,0,0,0,32,0,10,0,0,0,31,0,0,157296,31,10,0,32,0
21,371,02770,0,0,0,11,0,0,0,0,0,15,0,0,60136,15,0,0,11,0
21,371,02771,0,0,0,14,0,5,0,0,0,9,0,0,34210,9,5,0,14,0
21,371,02772,0,2,85,1,26,0,5,1,0,1,119509,119,42637,119510,5,1,27,2
21,371,02773,0,0,0,10,7,5,3,0,0,10,2,0,44039,12,8,0,17,0
21,371,02774,0,3,178,0,55,0,51,37,0,0,12,216,80706,12,51,37,55,3
21,371,02775,0,0,0,6,0,1,0,0,0,5,0,0,26445,5,1,0,6,0
21,371,02776,0,4,116,3,45,0,25,20,0,3,41682,156,122817,41685,25,20,48,4
21,371,02777,0,0,0,5,0,0,0,0,0,5,0,0,27566,5,0,0,5,0
21,371,02778,0,0,0,39,0,12,0,0,0,25,0,0,99128,25,12,0,39,0
21,371,02779,0,0,0,14,0,4,0,0,0,13,0,0,41735,13,4,0,14,0
21,372,02780,0,0,0,31,0,7,0,0,0,28,0,0,59141,28,7,0,31,0
21,372,02781,0,0,0,40,0,10,0,0,0,37,0,0,76530,37,10,0,40,0
21,372,02782,0,1,44,25,47,1,11,9,0,24,3,54,81396,27,12,9,72,1
21,372,02783,0,0,0,12,0,5,0,0,0,8,0,0,29875,8,5,0,12,0
21,372,02784,0,0,0,4,0,0,0,0,0,4,0,0,26915,4,0,0,4,0
21,372,02785,0,1,25,1,6,0,4,2,0,1,3,25,26859,4,4,2,7,1
21,372,02786,0,0,0,17,0,6,0,0,0,28,0,0,63790,28,6,0,17,0
21,372,02787,0,1,20,0,29,0,9,2,0,0,4,32,37887,4,9,2,29,1
21,372,02788,0,1,772,9,817,0,35,33,0,9,8,772,85769,17,35,33,826,1
21,372,02789,0,0,0,0,0,0,0,0,0,0,0,0,7727,0,0,0,0,0
21,372,02790,0,0,0,2,0,0,0,0,0,10,0,0,12627,10,0,0,2,0
21,372,02791,0,0,0,20,0,7,0,0,0,15,0,0,46660,15,7,0,20,0
21,372,02792,0,0,0,27,0,7,0,0,0,26,0,0,59076,26,7,0,27,0
21,372,02793,0,0,0,7,0,2,0,0,0,5,0,0,20202,5,2,0,7,0
21,372,02794,0,0,0,17,0,3,0,0,0,14,0,0,57064,14,3,0,17,0
21,372,02795,0,0,0,11,0,2,0,0,0,10,0,0,44495,10,2,0,11,0
21,372,02796,0,0,0,12,0,4,0,0,0,10,0,0,29334,10,4,0,12,0
21,372,02797,0,1,50,13,27,3,13,11,0,11,56478,58,55178,56489,16,11,40,1
21,372,02798,0,0,0,11,0,5,0,0,0,10,0,0,29300,10,5,0,11,0
21,372,02799,0,3,213,0,62,0,73,49,0,0,23,267,189366,23,73,49,62,3
21,373,02800,0,3,80,27,132,12,64,13,0,23,11,109,107409,34,76,13,159,3
21,373,02801,0,0,0,41,0,19,0,0,0,28,0,0,72567,28,19,0,41,0
21,373,02802,0,0,0,21,0,5,0,0,0,14,0,0,52074,14,5,0,21,0
21,373,02803,0,0,0,15,0,1,0,0,0,17,0,0,78914,17,1,0,15,0
21,374,02804,1,0,0,49,0,15,0,0,7,30,0,0,84499,30,15,7,49,1
21,374,02805,0,0,0,34,0,7,0,0,0,27,0,0,70362,27,7,0,34,0
21,374,02806,0,0,0,29,0,8,0,0,0,20,0,0,42101,20,8,0,29,0
21,374,02807,0,0,0,24,0,8,0,0,0,12,0,0,35391,12,8,0,24,0
21,374,02808,0,3,204,0,128,0,24,22,0,0,16,237,48969,16,24,22,128,3
21,374,02809,0,0,0,22,0,4,0,0,0,18,0,0,74020,18,4,0,22,0
21,374,02810,0,0,0,30,0,6,0,0,0,21,0,0,57407,21,6,0,30,0
21,374,02811,0,0,0,42,0,8,0,0,0,31,0,0,80258,31,8,0,42,0
21,374,02812,0,0,0,41,0,11,0,0,0,29,0,0,77943,29,11,0,41,0
21,374,02813,0,0,0,30,0,6,0,0,0,25,0,0,66462,25,6,0,30,0
21,374,02814,0,3,92,34,94,7,39,9,0,26,168,197,166107,194,46,9,128,3
21,374,02815,0,0,0,18,0,6,0,0,0,16,0,0,43460,16,6,0,18,0
21,374,02816,0,2,50,16,35,0,18,4,0,16,16,60,96870,32,18,4,51,2
21,374,02817,1,0,0,39,0,20,0,0,7,20,0,0,61931,20,20,7,39,1
21,374,02818,0,0,0,43,0,8,0,0,0,30,0,0,98427,30,8,0,43,0
21,374,02819,0,0,0,3,0,0,0,0,0,3,0,0,14399,3,0,0,3,0
21,374,02820,0,0,0,20,0,4,0,0,0,17,0,0,57581,17,4,0,20,0
21,374,02821,0,0,0,1,12,0,4,0,0,1,2,25,26095,3,4,0,13,0
21,374,02822,0,0,0,2,0,0,0,0,0,2,0,0,5851,2,0,0,2,0
21,374,02823,0,1,28,3,5,0,2,1,0,3,1,28,24846,4,2,1,8,1
21,374,02824,1,0,0,14,0,8,0,0,7,5,0,0,21864,5,8,7,14,1
21,374,02825,0,0,0,18,0,3,0,0,0,16,0,0,42832,16,3,0,18,0
21,374,02826,0,1,0,11,23,0,23,23,0,13,3,0,40824,16,23,23,34,1
21,374,02827,0,0,0,33,0,5,0,0,0,27,0,0,77613,27,5,0,33,0
21,374,02828,0,0,0,19,0,3,0,0,0,15,0,0,35171,15,3,0,19,0
21,374,02829,0,0,0,15,0,4,0,0,0,11,0,0,23532,11,4,0,15,0
21,374,02830,0,1,30,11,56,0,10,5,0,52,3,56,61593,55,10,5,67,1
21,374,02831,0,0,0,4,0,0,0,0,0,4,0,0,19184,4,0,0,4,0
21,374,02832,0,6,195,0,166,0,83,26,0,0,127,455,320040,127,83,26,166,6
21,374,02833,0,2,721,0,923,0,164,100,0,0,29608,1100,216410,29608,164,100,923,2
21,375,02834,0,2,22,4,45,0,9,7,0,4,31,22,84130,35,9,7,49,2
21,375,02835,0,0,0,4,0,0,0,0,0,4,0,0,19993,4,0,0,4,0
21,375,02836,0,0,0,4,0,0,0,0,0,4,0,0,16560,4,0,0,4,0
21,375,02837,0,3,132,7,60,0,8,6,0,7,4703,152,72698,4710,8,6,67,3
21,375,02838,0,0,0,9,1,0,0,0,0,9,0,0,56271,9,0,0,10,0
21,375,02839,0,1,0,40,13,4,0,0,0,34,3,0,97068,37,4,0,53,1
21,375,02840,0,0,0,11,2,0,0,0,0,11,1,0,46888,12,0,0,13,0
21,375,02841,1,0,0,45,0,14,0,0,6,28,0,0,73664,28,14,6,45,1
21,375,02842,0,0,0,22,0,0,0,0,0,22,0,0,68564,22,0,0,22,0
21,375,02843,0,0,0,42,0,8,0,0,0,32,0,0,104675,32,8,0,42,0
21,375,02844,0,0,0,44,0,5,0,0,0,38,0,0,157325,38,5,0,44,0
21,375,02845,0,1,160,5,534,0,28,23,0,5,13,160,98880,18,28,23,539,1
21,375,02846,0,0,0,21,0,5,0,0,0,15,0,0,46056,15,5,0,21,0
21,375,02847,0,0,0,7,0,0,0,0,0,7,0,0,21741,7,0,0,7,0
21,375,02848,2,0,0,61,0,25,0,0,14,35,0,0,95672,35,25,14,61,2
21,375,02849,0,0,0,17,0,0,0,0,0,17,0,0,63244,17,0,0,17,0
21,375,02850,1,0,0,43,0,13,0,0,7,30,0,0,107080,30,13,7,43,1
21,375,02851,0,0,0,35,0,6,0,0,0,26,0,0,80669,26,6,0,35,0
21,375,02852,0,1,16,4,22,0,3,3,0,4,1,16,27560,5,3,3,26,1
21,375,02853,0,0,0,32,0,3,0,0,0,28,0,0,112707,28,3,0,32,0
21,375,02854,0,1,74,19,18,0,13,8,0,19,154,87,124193,173,13,8,37,1
21,375,02855,1,0,0,23,0,9,0,0,6,13,0,0,64222,13,9,6,23,1
21,375,02856,1,0,0,34,0,13,0,0,6,18,0,0,82486,18,13,6,34,1
21,375,02857,0,0,0,21,0,4,0,0,0,16,0,0,78693,16,4,0,21,0
21,376,02858,0,0,0,40,0,11,0,0,0,34,0,0,100478,34,11,0,40,0
21,376,02859,0,0,0,36,0,12,0,0,0,32,0,0,53224,32,12,0,36,0
21,376,02860,0,0,0,23,0,7,0,0,0,17,0,0,48811,17,7,0,23,0
21,376,02861,0,1,80,2,77,0,18,13,0,2,4,85,50798,6,18,13,79,1
21,376,02862,0,0,0,21,0,5,0,0,0,15,0,0,47360,15,5,0,21,0
21,376,02863,0,0,0,33,0,8,0,0,0,26,0,0,99648,26,8,0,33,0
21,376,02864,0,0,0,36,0,15,0,0,0,22,0,0,73864,22,15,0,36,0
21,376,02865,0,0,0,35,0,9,0,0,0,26,0,0,81689,26,9,0,35,0
21,376,02866,0,0,0,16,0,0,0,0,0,16,0,0,63890,16,0,0,16,0
21,376,02867,0,1,10,41,21,10,5,3,0,30,2,10,120654,32,15,3,62,1
21,376,02868,0,0,0,29,0,7,0,0,0,22,0,0,78147,22,7,0,29,0
21,376,02869,0,0,0,9,0,0,0,0,0,13,0,0,28900,13,0,0,9,0
21,376,02870,0,1,70,33,10,7,16,12,0,23,4,90,114359,27,23,12,43,1
21,376,02871,0,0,0,25,0,7,0,0,0,16,0,0,57729,16,7,0,25,0
21,376,02872,0,0,0,30,0,5,0,0,0,24,0,0,86940,24,5,0,30,0
21,376,02873,0,0,0,1,0,0,0,0,0,1,0,0,5138,1,0,0,1,0
21,376,02874,0,0,0,36,0,5,0,0,0,31,0,0,82447,31,5,0,36,0
21,376,02875,1,0,0,47,0,14,0,0,6,33,0,0,104668,33,14,6,47,1
21,376,02876,0,0,0,20,0,1,0,0,0,19,0,0,63297,19,1,0,20,0
21,376,02877,0,0,0,29,0,4,0,0,0,45,0,0,86355,45,4,0,29,0
21,376,02878,1,0,0,37,0,11,0,0,6,30,0,0,77335,30,11,6,37,1
21,376,02879,0,0,0,35,0,8,0,0,0,26,0,0,96447,26,8,0,35,0
21,376,02880,2,0,0,53,0,16,0,0,14,33,0,0,121886,33,16,14,53,2
21,376,02881,0,0,0,38,0,15,0,0,0,23,0,0,89611,23,15,0,38,0
21,376,02882,0,0,0,42,0,6,0,0,0,60,0,0,132484,60,6,0,42,0
21,376,02883,1,0,0,54,0,11,0,0,6,46,0,0,123457,46,11,6,54,1
21,376,02884,0,1,52,28,20,4,14,11,0,23,5,66,109982,28,18,11,48,1
21,376,02885,0,0,0,36,0,11,0,0,0,24,0,0,76364,24,11,0,36,0
21,376,02886,1,0,0,28,0,11,0,0,6,15,0,0,77369,15,11,6,28,1
21,376,02887,1,0,0,24,0,11,0,0,7,12,0,0,46804,12,11,7,24,1
21,376,02888,0,5,282,0,166,0,97,58,0,0,147,432,116849,147,97,58,166,5
21,377,02889,0,0,0,12,0,3,0,0,0,9,0,0,80325,9,3,0,12,0
21,377,02890,0,1,20,35,13,11,5,2,0,20,3,21,149024,23,16,2,48,1
21,377,02891,0,0,0,21,0,2,0,0,0,19,0,0,188431,19,2,0,21,0
21,377,02892,0,0,0,6,0,0,0,0,0,6,0,0,96017,6,0,0,6,0
21,377,02893,0,0,0,23,0,5,0,0,0,17,0,0,169812,17,5,0,23,0
21,377,02894,0,0,0,15,0,0,0,0,0,15,0,0,134059,15,0,0,15,0
21,377,02895,0,0,0,20,0,7,0,0,0,12,0,0,151625,12,7,0,20,0
21,377,02896,0,0,0,2,0,1,0,0,0,1,0,0,25189,1,1,0,2,0
21,377,02897,1,0,0,29,0,7,0,0,7,21,0,0,178760,21,7,7,29,1
21,377,02898,0,0,0,1,0,0,0,0,0,1,0,0,10222,1,0,0,1,0
21,377,02899,0,0,0,3,0,0,0,0,0,3,0,0,40588,3,0,0,3,0
21,377,02900,0,0,0,0,0,0,0,0,0,0,0,0,5237,0,0,0,0,0
21,377,02901,0,0,0,0,0,0,0,0,0,0,0,0,11249,0,0,0,0,0
21,377,02902,0,1,6,7,4,0,6,3,0,7,2,10,91501,9,6,3,11,1
21,377,02903,0,1,10,32,35,3,12,7,0,28,3,21,132053,31,15,7,67,1
21,377,02904,0,0,0,17,0,4,0,0,0,13,0,0,57479,13,4,0,17,0
21,377,02905,0,0,0,15,0,4,0,0,0,10,0,0,39665,10,4,0,15,0
21,377,02906,0,0,0,14,0,0,0,0,0,14,0,0,139328,14,0,0,14,0
21,377,02907,1,1,30,66,89,15,21,2,6,45,4,80,311380,49,36,8,155,2
21,377,02908,0,0,0,19,0,5,0,0,0,12,0,0,161494,12,5,0,19,0
21,377,02909,0,4,345,0,74,0,54,40,0,0,15,580,144373,15,54,40,74,4
21,378,02910,0,0,0,20,0,6,0,0,0,12,0,0,58238,12,6,0,20,0
21,378,02911,0,0,0,21,0,7,0,0,0,9,0,0,63430,9,7,0,21,0
21,378,02912,0,0,0,29,0,6,0,0,0,21,0,0,110397,21,6,0,29,0
21,378,02913,0,1,30,24,50,0,6,3,0,22,3,36,119261,25,6,3,74,1
21,378,02914,0,3,221,62,81,14,39,20,0,40,260,305,355388,300,53,20,143,3
21,378,02915,0,1,30,52,24,19,4,4,0,25,7,30,161507,32,23,4,76,1
21,378,02916,0,0,0,24,0,11,0,0,0,9,0,0,91197,9,11,0,24,0
21,378,02917,0,0,0,42,0,7,0,0,0,41,0,0,194968,41,7,0,42,0
21,378,02918,1,0,0,44,0,16,0,0,7,20,0,0,121894,20,16,7,44,1
21,378,02919,0,0,0,23,0,6,0,0,0,17,0,0,100905,17,6,0,23,0
21,378,02920,0,0,0,16,0,2,0,0,0,15,0,0,124559,15,2,0,16,0
21,378,02921,0,0,0,0,0,0,0,0,0,0,0,0,4075,0,0,0,0,0
21,379,02922,1,0,0,76,0,37,0,0,6,35,0,0,140785,35,37,6,76,1
21,379,02923,0,0,0,36,0,10,0,0,0,24,0,0,163030,24,10,0,36,0
21,379,02924,0,0,0,4,0,0,0,0,0,4,0,0,29491,4,0,0,4,0
21,379,02925,0,0,0,36,0,9,0,0,0,24,0,0,137772,24,9,0,36,0
21,379,02926,0,1,30,40,26,3,8,5,0,38,3,41,219063,41,11,5,66,1
21,379,02927,0,1,11,0,26,0,12,1,0,0,12,79,47006,12,12,1,26,1
21,379,02928,0,0,0,34,0,4,0,0,0,28,0,0,158841,28,4,0,34,0
21,379,02929,0,0,0,21,0,5,0,0,0,14,0,0,67946,14,5,0,21,0
21,379,02930,0,0,0,12,0,0,0,0,0,12,0,0,65800,12,0,0,12,0
21,379,02931,0,0,0,47,0,3,0,0,0,42,0,0,177285,42,3,0,47,0
21,379,02932,0,0,0,40,0,15,0,0,0,25,0,0,108163,25,15,0,40,0
21,379,02933,0,0,0,31,0,9,0,0,0,23,0,0,124344,23,9,0,31,0
21,380,02934,0,3,84,0,58,0,22,21,0,0,3,84,71637,3,22,21,58,3
21,380,02935,0,0,0,5,2,0,1,0,0,7,0,10,39766,7,1,0,7,0
21,380,02936,0,0,0,28,0,7,0,0,0,57,0,0,108905,57,7,0,28,0
21,380,02937,0,0,0,5,0,0,0,0,0,3,0,0,23509,3,0,0,5,0
21,380,02938,0,0,0,22,0,3,0,0,0,20,0,0,106768,20,3,0,22,0
21,380,02939,0,1,2,44,1,4,1,1,0,61,1,2,215685,62,5,1,45,1
21,380,02940,0,1,268,52,721,6,62,59,0,42,2,268,244448,44,68,59,773,1
21,380,02941,0,0,0,16,0,3,0,0,0,13,0,0,82749,13,3,0,16,0
21,380,02942,1,0,0,30,0,12,0,0,7,31,0,0,78016,31,12,7,30,1
21,380,02943,0,0,0,31,0,2,0,0,0,44,0,0,164799,44,2,0,31,0
21,381,02944,1,0,0,31,0,11,0,0,6,19,0,0,97399,19,11,6,31,1
21,381,02945,0,0,0,22,0,8,0,0,0,15,0,0,59511,15,8,0,22,0
21,381,02946,0,1,30,36,2,8,3,3,0,26,2,31,149493,28,11,3,38,1
21,381,02947,1,0,0,24,0,11,0,0,7,13,0,0,55220,13,11,7,24,1
21,381,02948,0,1,60,24,15,1,14,8,0,23,3,70,176538,26,15,8,39,1
21,381,02949,1,0,0,32,0,9,0,0,6,22,0,0,74639,22,9,6,32,1
21,381,02950,0,6,92,15,63,3,15,8,0,13,210,119,89109,223,18,8,78,6
21,381,02951,0,0,0,6,2,0,1,0,0,8,1,0,42545,9,1,0,8,0
21,381,02952,0,0,0,4,0,0,0,0,0,4,0,0,34032,4,0,0,4,0
21,381,02953,0,0,0,10,0,4,0,0,0,8,0,0,38741,8,4,0,10,0
21,381,02954,0,1,50,16,19,4,18,8,0,24,7,103,112821,31,22,8,35,1
21,381,02955,0,0,0,8,26,1,6,0,0,24,4,18,83645,28,7,0,34,0
21,381,02956,2,0,0,59,0,23,0,0,13,34,0,0,186912,34,23,13,59,2
21,381,02957,1,0,0,36,0,8,0,0,7,51,0,0,143416,51,8,7,36,1
21,381,02958,0,0,0,17,0,4,0,0,0,17,0,0,53424,17,4,0,17,0
21,381,02959,0,0,0,13,0,1,0,0,0,12,0,0,69334,12,1,0,13,0
21,381,02960,0,0,0,18,0,5,0,0,0,18,0,0,97566,18,5,0,18,0
21,381,02961,0,0,0,7,0,0,0,0,0,18,0,0,62359,18,0,0,7,0
21,381,02962,0,0,0,42,0,17,0,0,0,23,0,0,108636,23,17,0,42,0
21,381,02963,0,0,0,6,0,0,0,0,0,6,0,0,31409,6,0,0,6,0
21,381,02964,0,0,0,0,0,0,0,0,0,0,0,0,1034,0,0,0,0,0
21,381,02965,0,0,0,14,0,0,0,0,0,20,0,0,63968,20,0,0,14,0
21,381,02966,0,0,0,13,0,8,0,0,0,11,0,0,25503,11,8,0,13,0
21,381,02967,0,0,0,36,0,11,0,0,0,191,0,0,147459,191,11,0,36,0
21,381,02968,0,7,1908,0,1791,0,317,230,0,0,75,2077,610189,75,317,230,1791,7
21,382,02969,0,0,0,15,0,4,0,0,0,12,0,0,80344,12,4,0,15,0
21,382,02970,1,0,0,27,0,13,0,0,6,9,0,0,45810,9,13,6,27,1
21,382,02971,0,0,0,5,4,1,1,0,0,4,1,3,38517,5,2,0,9,0
21,382,02972,0,0,0,10,0,2,0,0,0,9,0,0,49415,9,2,0,10,0
21,382,02973,0,0,0,2,0,1,0,0,0,1,0,0,17424,1,1,0,2,0
21,382,02974,0,1,35,9,50,0,12,5,0,13,5,76,98235,18,12,5,59,1
21,382,02975,0,0,0,16,0,1,0,0,0,27,0,0,96807,27,1,0,16,0
21,382,02976,0,0,0,9,0,0,0,0,0,29,0,0,65386,29,0,0,9,0
21,382,02977,0,1,205,28,24,9,21,19,0,23,7,216,134846,30,30,19,52,1
21,382,02978,0,0,0,17,0,0,0,0,0,17,0,0,127526,17,0,0,17,0
21,382,02979,0,0,0,38,3,14,1,0,0,31,0,2,164782,31,15,0,41,0
21,382,02980,0,1,1,41,15,31,4,1,0,11,4,18,87695,15,35,1,56,1
21,382,02981,0,0,0,19,0,1,0,0,0,18,0,0,111320,18,1,0,19,0
21,382,02982,0,0,0,28,0,4,0,0,0,23,0,0,129490,23,4,0,28,0
21,382,02983,1,0,0,32,0,9,0,0,6,20,0,0,111407,20,9,6,32,1
21,382,02984,0,1,16,22,19,8,3,2,0,16,2,20,196754,18,11,2,41,1
21,382,02985,0,0,0,26,0,6,0,0,0,18,0,0,123911,18,6,0,26,0
21,382,02986,0,0,0,58,0,30,0,0,0,25,0,0,146335,25,30,0,58,0
21,383,02987,2,0,0,74,0,36,0,0,14,31,0,0,164352,31,36,14,74,2
21,383,02988,0,1,43,41,46,11,9,6,0,24,7,59,117033,31,20,6,87,1
21,383,02989,2,0,0,61,0,34,0,0,14,17,0,0,61184,17,34,14,61,2
21,383,02990,0,1,35,21,27,0,7,4,0,15,2,44,100949,17,7,4,48,1
21,383,02991,3,0,0,65,0,31,0,0,21,30,0,0,104409,30,31,21,65,3
21,383,02992,0,0,0,11,0,0,0,0,0,15,0,0,53390,15,0,0,11,0
21,383,02993,1,0,0,36,0,16,0,0,7,15,0,0,53717,15,16,7,36,1
21,383,02994,3,0,0,64,0,34,0,0,21,17,0,0,61946,17,34,21,64,3
21,383,02995,0,0,0,6,0,0,0,0,0,4,0,0,26813,4,0,0,6,0
21,383,02996,0,0,0,10,0,2,0,0,0,8,0,0,47592,8,2,0,10,0
21,383,02997,1,0,0,28,0,13,0,0,8,13,0,0,44082,13,13,8,28,1
21,383,02998,0,0,0,22,0,3,0,0,0,18,0,0,73813,18,3,0,22,0
21,383,02999,2,3,186,67,65,23,42,35,14,37,30,206,282580,67,65,49,132,5
21,384,02995,0,0,0,0,0,0,0,0,0,0,0,0,1098,0,0,0,0,0
21,384,03000,0,1,70,14,22,0,6,5,0,17,1,72,66330,18,6,5,36,1
21,384,03001,0,0,0,15,0,4,0,0,0,50,0,0,63128,50,4,0,15,0
21,384,03002,0,1,4,4,5,0,3,2,0,4,1,5,37786,5,3,2,9,1
21,384,03003,0,0,0,14,0,4,0,0,0,13,0,0,55678,13,4,0,14,0
21,384,03004,0,0,0,1,0,0,0,0,0,1,0,0,16550,1,0,0,1,0
21,384,03005,0,0,0,7,15,2,2,0,0,5,1,6,31312,6,4,0,22,0
21,384,03006,0,1,56,8,24,0,13,10,0,8,5,66,97602,13,13,10,32,1
21,384,03007,0,2,190,7,43,0,21,16,0,8,7,203,61722,15,21,16,50,2
21,384,03008,0,1,45,2,16,0,9,4,0,2,67,49,25772,69,9,4,18,1
21,384,03009,0,1,54,3,15,1,8,4,0,3,4,57,50318,7,9,4,18,1
21,384,03010,0,0,0,14,12,5,13,0,0,8,4,24,78702,12,18,0,26,0
21,384,03011,0,1,120,15,48,2,25,22,0,13,4,149,155006,17,27,22,63,1
21,384,03012,1,0,0,19,0,6,0,0,6,13,0,0,61290,13,6,6,19,1
21,384,03013,0,0,0,5,0,2,0,0,0,3,0,0,34239,3,2,0,5,0
21,384,03014,1,0,0,30,0,12,0,0,7,17,0,0,103637,17,12,7,30,1
21,384,03015,1,0,0,18,0,10,0,0,8,9,0,0,51565,9,10,8,18,1
21,384,03016,0,0,0,15,0,2,0,0,0,13,0,0,56039,13,2,0,15,0
21,384,03017,0,1,48,12,30,3,7,7,0,10,2,54,56764,12,10,7,42,1
21,384,03018,0,0,0,4,0,0,0,0,0,4,0,0,15670,4,0,0,4,0
21,384,03019,0,0,0,10,0,0,0,0,0,10,0,0,49824,10,0,0,10,0
21,384,03020,0,0,0,9,0,2,0,0,0,7,0,0,29498,7,2,0,9,0
21,384,03021,0,0,0,19,0,4,0,0,0,14,0,0,71641,14,4,0,19,0
21,385,03022,0,0,0,20,0,8,0,0,0,13,0,0,38000,13,8,0,20,0
21,385,03023,1,1,50,42,27,21,9,3,7,25,2,64,76575,27,30,10,69,2
21,385,03024,0,0,0,5,0,0,0,0,0,5,0,0,24934,5,0,0,5,0
21,385,03025,0,0,0,23,0,10,0,0,0,12,0,0,43706,12,10,0,23,0
21,385,03026,0,2,28,22,26,6,5,4,0,22,3,32,95765,25,11,4,48,2
21,385,03027,0,0,0,32,0,8,0,0,0,23,0,0,125510,23,8,0,32,0
21,385,03028,0,1,168,9,74,3,36,22,0,6,15,250,60036,21,39,22,83,1
21,385,03029,0,0,0,23,2,9,1,0,0,13,1,10,71640,14,10,0,25,0
21,385,03030,0,0,0,12,0,1,0,0,0,11,0,0,48832,11,1,0,12,0
21,385,03031,1,1,10,32,11,9,4,2,6,22,2,23,115446,24,13,8,43,2
21,385,03032,0,0,0,46,0,23,0,0,0,27,0,0,106763,27,23,0,46,0
21,385,03033,0,3,78,35,139,4,22,11,0,31,5,151,150317,36,26,11,174,3
21,386,03034,1,0,0,36,0,13,0,0,6,20,0,0,90754,20,13,6,36,1
21,386,03035,0,0,0,31,0,14,0,0,0,26,0,0,97128,26,14,0,31,0
21,386,03036,0,1,100,37,91,11,32,21,0,24,7,152,139977,31,43,21,128,1
21,386,03037,0,0,0,10,4,0,1,0,0,12,1,1,61998,13,1,0,14,0
21,386,03038,0,0,0,18,0,5,0,0,0,15,0,0,55468,15,5,0,18,0
21,386,03039,0,0,0,3,0,1,0,0,0,4,0,0,17670,4,1,0,3,0
21,386,03041,0,0,0,1,0,0,0,0,0,1,0,0,5117,1,0,0,1,0
21,386,03042,1,1,6,33,31,10,7,5,7,18,2,22,91728,20,17,12,64,2
21,386,03043,0,0,0,26,0,4,0,0,0,22,0,0,132791,22,4,0,26,0
21,386,03044,0,0,0,0,0,0,0,0,0,0,0,0,189,0,0,0,0,0
21,386,03045,0,0,0,3,0,0,0,0,0,3,0,0,13445,3,0,0,3,0
21,386,03046,0,0,0,1,0,0,0,0,0,1,0,0,12889,1,0,0,1,0
21,386,03047,0,0,0,0,0,0,0,0,0,0,0,0,2572,0,0,0,0,0
21,386,03048,0,0,0,2,0,0,0,0,0,2,0,0,16363,2,0,0,2,0
21,386,03049,0,1,80,16,87,5,17,7,0,15,235,153,126358,250,22,7,103,1
21,386,03050,1,0,0,33,0,13,0,0,7,19,0,0,84522,19,13,7,33,1
21,386,03051,0,0,0,4,0,0,0,0,0,4,0,0,37963,4,0,0,4,0
21,386,03052,1,0,0,42,18,15,6,0,6,23,1,27,151953,24,21,6,60,1
21,386,03053,0,1,16,15,19,0,2,2,0,15,277,16,113604,292,2,2,34,1
21,386,03054,0,1,20,24,44,4,10,2,0,36,6,66,112802,42,14,2,68,1
21,386,03055,0,8,2250,0,1580,0,394,275,0,0,109,2755,885363,109,394,275,1580,8
21,387,03056,0,0,0,23,0,5,0,0,0,32,0,0,109204,32,5,0,23,0
21,387,03057,0,1,12,27,14,3,8,2,0,23,5,30,159582,28,11,2,41,1
21,387,03058,1,1,20,61,15,19,10,7,7,61,7,26,207995,68,29,14,76,2
21,387,03059,1,0,0,30,0,16,0,0,7,14,0,0,100479,14,16,7,30,1
21,387,03060,0,0,0,24,0,4,0,0,0,19,0,0,67697,19,4,0,24,0
21,387,03061,0,1,20,5,12,1,5,2,0,8,2,20,54994,10,6,2,17,1
21,387,03062,0,0,0,26,0,6,0,0,0,29,0,0,121636,29,6,0,26,0
21,387,03063,0,0,0,4,0,0,0,0,0,12,0,0,22400,12,0,0,4,0
21,387,03064,0,0,0,50,0,14,0,0,0,38,0,0,196067,38,14,0,50,0
21,387,03065,0,0,0,27,0,8,0,0,0,17,0,0,87919,17,8,0,27,0
21,387,03066,1,0,0,17,0,8,0,0,7,9,0,0,107551,9,8,7,17,1
21,387,03067,0,0,0,28,0,6,0,0,0,21,0,0,132207,21,6,0,28,0
21,387,03068,0,0,0,15,0,0,0,0,0,15,0,0,71864,15,0,0,15,0
21,387,03069,1,0,0,31,0,14,0,0,7,30,0,0,57457,30,14,7,31,1
21,387,03070,0,8,540,0,159,0,68,32,0,0,22,727,200564,22,68,32,159,8
21,388,03071,0,1,20,38,5,8,2,1,0,29,1,20,84806,30,10,1,43,1
21,388,03072,1,1,16,72,29,43,7,2,7,27,3,41,136106,30,50,9,101,2
21,388,03073,0,0,0,28,0,10,0,0,0,15,0,0,79840,15,10,0,28,0
21,388,03074,1,3,190,47,96,14,30,24,7,28,17763,231,177161,17791,44,31,143,4
21,388,03075,0,0,0,56,0,19,0,0,0,32,0,0,114257,32,19,0,56,0
21,388,03076,0,1,10,12,10,1,2,2,0,13,11,10,87473,24,3,2,22,1
21,388,03077,0,0,0,29,5,6,3,0,0,24,1,30,125196,25,9,0,34,0
21,388,03078,0,1,30,98,5,41,6,6,0,42,3,30,143613,45,47,6,103,1
21,388,03079,0,1,3,24,1,8,1,1,0,10,1,3,57480,11,9,1,25,1
21,388,03080,0,1,25,31,23,2,8,2,0,32,5,51,176532,37,10,2,54,1
21,388,03081,0,1,30,40,57,5,11,3,0,30,3,55,136231,33,16,3,97,1
21,388,03082,0,1,30,24,16,5,4,2,0,18,1,40,151072,19,9,2,40,1
21,388,03083,0,2,55,19,26,3,8,6,0,16,2,55,146657,18,11,6,45,2
21,388,03084,0,1,6,17,23,5,7,0,0,21,4,9,95646,25,12,0,40,1
21,388,03085,0,1,30,28,32,12,9,6,0,16,1,30,94683,17,21,6,60,1
21,388,03086,0,1,25,10,14,3,8,1,0,4,4,41,45243,8,11,1,24,1
21,388,03087,0,0,0,10,0,0,0,0,0,10,0,0,48224,10,0,0,10,0
21,388,03088,0,0,0,0,0,0,0,0,0,0,0,0,8001,0,0,0,0,0
21,388,03089,0,1,10,45,15,10,3,2,0,33,4,10,159869,37,13,2,60,1
21,388,03090,0,2,22,51,29,18,8,4,0,27,17,47,162745,44,26,4,80,2
21,388,03091,1,0,0,30,0,9,0,0,7,33,0,0,133359,33,9,7,30,1
21,388,03092,0,1,16,18,15,4,7,7,0,13,1,16,66156,14,11,7,33,1
21,388,03093,0,1,6,48,12,10,3,2,0,31,2,26,143743,33,13,2,60,1
21,388,03094,0,1,26,5,19,0,7,2,0,10,4,36,67957,14,7,2,24,1
21,388,03095,0,0,0,31,10,7,3,0,0,31,2,13,147582,33,10,0,41,0
21,388,03096,2,2,6,55,11,23,7,4,14,38,3,9,137114,41,30,18,66,4
21,388,03097,0,1,20,34,22,12,4,2,0,28,2,20,114264,30,16,2,56,1
21,388,03098,1,1,30,41,31,10,7,4,7,26,4,60,114649,30,17,11,72,2
21,388,03099,0,6,1250,0,1019,0,126,77,0,0,49,1420,356598,49,126,77,1019,6
21,388,03109,0,0,0,5,0,0,0,0,0,5,0,0,12227,5,0,0,5,0
21,389,03100,0,0,0,26,0,8,0,0,0,21,0,0,58617,21,8,0,26,0
21,389,03101,1,1,50,31,49,10,17,4,6,20,1209,106,73540,1229,27,10,80,2
21,389,03102,1,1,18,33,20,9,7,2,7,27,3,48,85689,30,16,9,53,2
21,389,03103,0,0,0,28,0,6,0,0,0,23,0,0,77271,23,6,0,28,0
21,389,03104,0,1,16,14,5,1,1,1,0,13,3,16,51825,16,2,1,19,1
21,389,03105,0,1,111,7,27,0,20,12,0,8,11658,124,77544,11666,20,12,34,1
21,389,03106,0,0,0,24,0,6,0,0,0,19,0,0,45009,19,6,0,24,0
21,389,03107,0,1,16,17,8,4,4,3,0,15,1,16,46015,16,8,3,25,1
21,389,03108,0,0,0,8,0,0,0,0,0,8,0,0,29318,8,0,0,8,0
21,389,03109,0,0,0,7,0,0,0,0,0,7,0,0,29716,7,0,0,7,0
21,390,03110,1,0,0,20,0,9,0,0,7,14,0,0,33896,14,9,7,20,1
21,390,03111,0,0,0,22,0,5,0,0,0,13,0,0,40308,13,5,0,22,0
21,390,03112,0,2,186,0,127,0,34,30,0,0,5,226,38732,5,34,30,127,2
21,390,03113,0,0,0,22,0,7,0,0,0,25,0,0,41845,25,7,0,22,0
21,390,03114,0,1,30,29,21,14,6,5,0,16,3,30,48757,19,20,5,50,1
21,390,03115,0,0,0,31,0,10,0,0,0,17,0,0,48203,17,10,0,31,0
21,390,03116,0,0,0,15,0,4,0,0,0,38,0,0,22395,38,4,0,15,0
21,390,03117,1,0,0,25,0,12,0,0,8,17,0,0,35015,17,12,8,25,1
21,390,03118,0,0,0,26,0,7,0,0,0,16,0,0,52299,16,7,0,26,0
21,390,03119,0,1,66,34,35,12,11,9,0,33,3,78,95474,36,23,9,69,1
21,390,03120,0,0,0,110,0,85,0,0,0,70,0,0,19043,70,85,0,110,0
21,390,03121,0,0,0,13,0,5,0,0,0,6,0,0,28292,6,5,0,13,0
21,390,03122,1,0,0,18,0,10,0,0,8,8,0,0,18600,8,10,8,18,1
21,390,03123,1,0,0,28,0,15,0,0,7,18,0,0,47707,18,15,7,28,1
21,390,03124,1,0,0,20,0,12,0,0,9,9,0,0,36249,9,12,9,20,1
21,390,03125,0,1,16,20,24,4,8,2,0,16,7,30,63159,23,12,2,44,1
21,390,03126,0,0,0,37,0,18,0,0,0,20,0,0,52437,20,18,0,37,0
21,391,03127,3,0,0,53,0,27,0,0,21,18,0,0,76990,18,27,21,53,3
21,391,03128,0,0,0,38,0,10,0,0,0,24,0,0,105674,24,10,0,38,0
21,391,03129,0,0,0,14,0,5,0,0,0,10,0,0,43717,10,5,0,14,0
21,391,03130,1,1,92,34,15,9,13,10,7,21,2,98,136805,23,22,17,49,2
21,391,03131,2,0,0,36,0,24,0,0,16,11,0,0,36409,11,24,16,36,2
21,391,03132,1,0,0,26,0,11,0,0,7,22,0,0,38592,22,11,7,26,1
21,392,03133,0,0,0,36,0,9,0,0,0,31,0,0,115592,31,9,0,36,0
21,392,03134,0,0,0,14,0,5,0,0,0,21,0,0,43191,21,5,0,14,0
21,392,03135,1,1,16,27,15,9,4,3,7,18,4,16,96585,22,13,10,42,2
21,392,03136,0,0,0,15,0,6,0,0,0,8,0,0,40804,8,6,0,15,0
21,392,03137,0,0,0,23,0,7,0,0,0,23,0,0,100120,23,7,0,23,0
21,392,03138,0,1,6,5,0,0,2,2,0,11,1,6,43379,12,2,2,5,1
21,392,03139,0,1,169,5,254,0,13,12,0,5,4,177,60446,9,13,12,259,1
21,392,03140,1,1,20,33,9,14,5,1,7,32,2,36,108632,34,19,8,42,2
21,393,03141,0,1,4,81,1,15,0,0,0,51,1,4,152865,52,15,0,82,1
21,393,03142,0,4,206,106,57,13,39,27,0,74,12,245,326994,86,52,27,163,4
21,393,03143,0,1,4,90,8,16,2,1,0,42,4,9,185028,46,18,1,98,1
21,393,03144,0,1,26,56,19,10,8,8,0,28,6,26,168325,34,18,8,75,1
21,393,03145,1,0,0,48,0,13,0,0,7,50,0,0,89819,50,13,7,48,1
21,393,03146,0,0,0,22,0,1,0,0,0,12,0,0,52373,12,1,0,22,0
21,393,03147,0,0,0,77,0,19,0,0,0,23,0,0,116090,23,19,0,77,0
21,393,03148,0,0,0,55,0,7,0,0,0,48,0,0,143560,48,7,0,55,0
21,393,03149,0,1,30,17,18,5,5,5,0,10,2,30,72115,12,10,5,35,1
21,393,03150,0,0,0,24,0,0,0,0,0,14,0,0,74579,14,0,0,24,0
21,393,03151,0,0,0,43,0,10,0,0,0,26,0,0,98729,26,10,0,43,0
21,393,03152,0,1,84,87,47,16,11,9,0,32,5,90,162824,37,27,9,134,1
21,394,03153,1,1,16,44,13,18,5,2,7,17,3,16,75537,20,23,9,57,2
21,394,03154,2,0,0,60,0,26,0,0,16,23,0,0,99515,23,26,16,60,2
21,394,03155,0,0,0,97,0,38,0,0,0,37,0,0,126935,37,38,0,97,0
21,394,03156,1,1,16,50,25,19,6,5,8,24,204,16,126837,228,25,13,75,2
21,394,03157,1,0,0,49,0,23,0,0,8,18,0,0,76504,18,23,8,49,1
21,394,03158,0,0,0,39,0,11,0,0,0,22,0,0,104434,22,11,0,39,0
21,395,03159,0,1,50,31,49,5,5,4,0,26,4,50,141349,30,10,4,80,1
21,395,03160,3,1,30,60,16,33,5,3,24,27,4,45,137174,31,38,27,76,4
21,395,03161,0,0,0,27,0,5,0,0,0,21,0,0,109291,21,5,0,27,0
21,395,03162,0,0,0,12,0,1,0,0,0,16,0,0,46554,16,1,0,12,0
21,395,03163,0,0,0,11,0,3,0,0,0,7,0,0,22711,7,3,0,11,0
21,395,03164,1,2,150,45,78,10,53,38,6,31,13,272,218407,44,63,44,123,3
21,395,03165,1,0,0,45,0,16,0,0,6,23,0,0,102646,23,16,6,45,1
21,395,03166,0,1,50,49,5,18,7,4,0,35,3,50,181465,38,25,4,54,1
21,395,03167,0,0,0,28,0,10,0,0,0,33,0,0,78196,33,10,0,28,0
21,395,03168,1,0,0,54,0,18,0,0,7,43,0,0,108110,43,18,7,54,1
21,395,03169,0,0,0,39,0,7,0,0,0,36,0,0,158705,36,7,0,39,0
21,395,03170,2,1,7,68,23,25,6,2,14,37,2,12,190759,39,31,16,91,3
21,395,03171,0,0,0,28,0,5,0,0,0,39,0,0,77220,39,5,0,28,0
21,396,03172,0,0,0,15,0,2,0,0,0,13,0,0,52667,13,2,0,15,0
21,396,03173,0,1,20,88,36,43,7,2,0,43,5,30,54773,48,50,2,124,1
21,396,03174,0,0,0,39,0,16,0,0,0,21,0,0,28492,21,16,0,39,0
21,396,03175,0,1,16,21,37,1,6,3,0,36,3,33,87146,39,7,3,58,1
21,396,03176,0,1,6,22,9,5,4,2,0,19,1,9,65313,20,9,2,31,1
21,396,03177,0,0,0,23,0,5,0,0,0,15,0,0,69301,15,5,0,23,0
21,396,03178,0,0,0,3,0,0,0,0,0,3,0,0,15120,3,0,0,3,0
21,396,03179,0,0,0,9,0,0,0,0,0,9,0,0,35311,9,0,0,9,0
21,396,03180,0,0,0,2,0,0,0,0,0,2,0,0,19399,2,0,0,2,0
21,396,03181,0,1,99,43,60,3,19,17,0,39,5,116,222121,44,22,17,103,1
21,396,03182,0,0,0,19,0,3,0,0,0,15,0,0,47387,15,3,0,19,0
21,396,03183,0,1,60,37,13,6,8,7,0,29,13,70,114687,42,14,7,50,1
21,396,03184,0,1,6,12,48,0,5,2,0,12,3,6,65210,15,5,2,60,1
21,396,03185,0,0,0,22,0,5,0,0,0,14,0,0,44639,14,5,0,22,0
21,396,03186,0,0,0,12,0,0,0,0,0,12,0,0,39390,12,0,0,12,0
21,397,03187,1,1,10,38,8,11,5,1,8,27,3,26,133537,30,16,9,46,2
21,397,03188,1,0,0,31,0,13,0,0,8,20,0,0,50000,20,13,8,31,1
21,397,03189,0,2,40,46,48,4,10,2,0,44,3,96,206012,47,14,2,94,2
21,397,03190,1,0,0,30,0,10,0,0,7,19,0,0,73953,19,10,7,30,1
21,397,03191,0,0,0,26,0,5,0,0,0,14,0,0,82967,14,5,0,26,0
21,397,03192,3,0,0,88,0,28,0,0,19,77,0,0,155383,77,28,19,88,3
21,397,03193,1,1,20,33,12,6,8,3,6,33,2,43,99699,35,14,9,45,2
21,397,03194,1,0,0,52,0,17,0,0,6,31,0,0,105973,31,17,6,52,1
21,397,03195,0,0,0,53,0,14,0,0,0,29,0,0,93166,29,14,0,53,0
21,397,03196,1,2,144,52,31,17,12,7,6,34,6,168,118957,40,29,13,83,3
21,397,03197,1,0,0,45,0,12,0,0,6,30,0,0,70316,30,12,6,45,1
21,397,03198,2,1,32,35,24,17,4,3,13,18,1,32,30938,19,21,16,59,3
21,398,03199,0,1,16,58,35,25,6,1,0,28,4,24,120928,32,31,1,93,1
21,398,03200,0,5,16,32,17,9,14,5,0,23,8,35,98341,31,23,5,49,5
21,398,03201,1,0,0,49,0,19,0,0,6,27,0,0,70420,27,19,6,49,1
21,398,03202,0,0,0,17,0,3,0,0,0,9,0,0,50637,9,3,0,17,0
21,398,03203,0,0,0,16,0,6,0,0,0,20,0,0,40155,20,6,0,16,0
21,398,03204,0,0,0,14,0,2,0,0,0,12,0,0,43352,12,2,0,14,0
21,398,03205,0,0,0,23,0,4,0,0,0,20,0,0,58759,20,4,0,23,0
21,398,03206,0,0,0,4,0,0,0,0,0,4,0,0,25283,4,0,0,4,0
21,398,03207,1,0,0,36,0,13,0,0,6,23,0,0,68035,23,13,6,36,1
21,398,03208,0,5,155,1,130,0,41,30,0,1,8,201,54832,9,41,30,131,5
21,398,03209,0,1,101,23,65,6,9,8,0,18,7977,117,181864,7995,15,8,88,1
21,398,03210,0,0,0,32,0,9,0,0,0,23,0,0,57038,23,9,0,32,0
21,398,03211,0,0,0,43,0,9,0,0,0,30,0,0,124484,30,9,0,43,0
21,398,03212,0,0,0,18,0,4,0,0,0,14,0,0,40941,14,4,0,18,0
21,398,03213,0,0,0,17,0,0,0,0,0,21,0,0,54416,21,0,0,17,0
21,398,03214,1,0,0,41,0,12,0,0,7,27,0,0,72417,27,12,7,41,1
21,398,03215,0,0,0,7,0,0,0,0,0,7,0,0,22247,7,0,0,7,0
21,398,03216,0,2,90,1,90,0,27,21,0,1,6,115,65664,7,27,21,91,2
21,398,03217,0,2,34,3,29,0,9,4,0,3,6,62,29431,9,9,4,32,2
21,398,03218,0,0,0,41,0,12,0,0,0,25,0,0,88061,25,12,0,41,0
21,398,03219,0,0,0,4,0,0,0,0,0,4,0,0,10038,4,0,0,4,0
21,399,03220,0,1,105,42,42,10,13,12,0,41,2,115,177361,43,23,12,84,1
21,399,03221,0,0,0,36,0,10,0,0,0,23,0,0,83927,23,10,0,36,0
21,399,03222,0,0,0,21,0,3,0,0,0,16,0,0,29502,16,3,0,21,0
21,399,03223,0,1,40,6,16,1,4,2,0,4,2,40,33390,6,5,2,22,1
21,399,03224,0,0,0,4,0,0,0,0,0,4,0,0,14856,4,0,0,4,0
21,399,03225,0,0,0,6,0,2,0,0,0,3,0,0,14267,3,2,0,6,0
21,399,03226,0,2,6,19,5,8,3,3,0,13,72,6,74500,85,11,3,24,2
21,399,03227,0,0,0,26,0,4,0,0,0,22,0,0,76658,22,4,0,26,0
21,399,03228,0,0,0,16,0,6,0,0,0,9,0,0,28224,9,6,0,16,0
21,399,03229,0,0,0,9,0,1,0,0,0,8,0,0,43705,8,1,0,9,0
21,399,03230,0,0,0,18,0,7,0,0,0,9,0,0,34728,9,7,0,18,0
22,400,03231,0,0,0,63,0,8,0,0,0,51,0,0,88546,51,8,0,63,0
22,400,03232,0,5,240,66,170,9,31,20,0,50,23,500,182933,73,40,20,236,5
22,400,03233,0,0,0,55,0,8,0,0,0,40,0,0,48370,40,8,0,55,0
22,400,03234,0,5,205,48,242,8,30,8,0,29,17,369,148817,46,38,8,290,5
22,400,03235,0,0,0,49,0,6,0,0,0,36,0,0,104440,36,6,0,49,0
22,401,03236,0,1,30,41,40,4,4,3,0,41,12,60,168020,53,8,3,81,1
22,401,03237,0,1,20,47,36,8,6,2,0,43,9,51,110409,52,14,2,83,1
22,401,03238,0,1,100,54,53,4,22,5,0,57,3,430,160974,60,26,5,107,1
22,401,03239,0,2,33,66,50,9,5,5,0,56,9,33,150783,65,14,5,116,2
22,401,03240,0,1,10,60,92,8,8,2,0,37,1,40,109932,38,16,2,152,1
22,401,03241,0,0,0,42,0,7,0,0,0,22,0,0,72088,22,7,0,42,0
22,401,03242,0,3,150,76,36,12,7,7,0,72,11,180,232380,83,19,7,112,3
22,401,03243,0,0,0,88,0,7,0,0,0,36,0,0,87603,36,7,0,88,0
22,401,03244,0,0,0,94,10,13,4,0,0,56,2,2,131216,58,17,0,104,0
22,401,03245,0,0,0,61,0,11,0,0,0,60,0,0,122233,60,11,0,61,0
22,401,03246,0,1,30,41,30,1,1,1,0,25,2,30,64797,27,2,1,71,1
22,401,03247,0,8,480,103,91,13,35,30,0,54,23,516,279717,77,48,30,194,8
22,401,03248,0,1,30,40,40,2,2,2,0,33,1,30,118921,34,4,2,80,1
22,401,03249,0,0,0,45,0,5,0,0,0,23,0,0,78918,23,5,0,45,0
22,401,03250,0,1,10,37,30,5,4,4,0,35,3,20,109022,38,9,4,67,1
22,401,03251,0,0,0,66,0,19,0,0,0,45,0,0,119800,45,19,0,66,0
22,401,03252,0,1,30,42,24,2,6,5,0,30,4,60,96131,34,8,5,66,1
22,401,03253,0,0,0,29,0,3,0,0,0,23,0,0,70244,23,3,0,29,0
22,401,03254,0,0,0,35,0,3,0,0,0,25,0,0,76573,25,3,0,35,0
22,402,03255,0,0,0,112,30,15,3,0,0,69,4,10,171711,73,18,0,142,0
22,402,03256,0,0,0,63,0,8,0,0,0,29,0,0,76735,29,8,0,63,0
22,402,03257,0,1,100,29,45,3,15,14,0,35,10,124,96360,45,18,14,74,1
22,402,03258,0,0,0,25,0,2,0,0,0,33,0,0,60695,33,2,0,25,0
22,402,03259,0,1,30,37,10,6,5,5,0,35,3,30,95300,38,11,5,47,1
22,402,03260,0,0,0,64,0,8,0,0,0,18,0,0,50840,18,8,0,64,0
22,402,03261,0,0,0,143,0,29,0,0,0,46,0,0,108498,46,29,0,143,0
22,402,03262,0,2,56,81,127,15,16,7,0,57,18,206,191530,75,31,7,208,2
22,403,03263,0,0,0,101,49,29,3,0,0,78,4,30,207030,82,32,0,150,0
22,403,03264,0,0,0,58,39,4,6,0,0,47,5,32,130613,52,10,0,97,0
22,403,03265,0,1,30,46,75,13,4,0,0,30,5,60,79425,35,17,0,121,1
22,403,03266,0,0,0,63,0,8,0,0,0,33,0,0,97926,33,8,0,63,0
22,403,03267,0,14,677,66,42,14,33,32,0,55,54,707,307497,109,47,32,108,14
22,403,03268,0,0,0,70,31,10,3,0,0,41,7,30,139799,48,13,0,101,0
22,403,03269,0,1,100,59,32,6,5,5,0,67,4,100,150627,71,11,5,91,1
22,403,03270,0,1,40,53,36,7,6,6,0,45,8,50,229411,53,13,6,89,1
22,403,03271,0,0,0,41,47,1,4,0,0,53,15,36,151237,68,5,0,88,0
22,404,03272,0,2,130,38,185,5,39,25,0,33,18,185,163402,51,44,25,223,2
22,404,03273,0,0,0,79,0,11,0,0,0,69,0,0,188741,69,11,0,79,0
22,404,03274,0,1,30,65,24,12,5,5,0,63,5,30,198746,68,17,5,89,1
22,404,03275,0,1,0,76,0,12,3,3,0,81,3,0,144577,84,15,3,76,1
22,404,03276,0,0,0,73,0,8,0,0,0,70,0,0,145796,70,8,0,73,0
22,405,03277,0,0,0,21,61,3,21,0,0,20,10,100,153060,30,24,0,82,0
22,405,03278,0,1,30,35,31,5,8,4,0,31,8,64,175982,39,13,4,66,1
22,405,03279,0,0,0,36,10,5,18,0,0,32,7,43,103219,39,23,0,46,0
22,405,03280,0,5,6,32,13,4,1,0,0,25,10,16,156947,35,5,0,45,5
22,405,03281,0,1,50,68,182,11,49,6,0,34,16,100,211189,50,60,6,250,1
22,405,03282,0,2,36,56,83,6,16,4,0,39,17,78,176431,56,22,4,139,2
22,405,03283,0,0,0,50,0,7,21,0,0,36,8,60,166176,44,28,0,50,0
22,405,03284,0,1,30,43,22,7,11,3,0,44,9,108,164863,53,18,3,65,1
22,405,03285,0,0,0,44,0,7,1,0,0,38,1,0,147447,39,8,0,44,0
22,405,03286,0,0,0,46,0,2,18,0,0,36,1,30,164249,37,20,0,46,0
22,406,03287,0,0,0,28,0,3,0,0,0,33,7,0,134135,40,3,0,28,0
22,406,03288,0,0,0,38,0,5,0,0,0,39,0,0,116804,39,5,0,38,0
22,406,03289,0,1,16,25,15,5,3,3,0,21,7,16,85481,28,8,3,40,1
22,406,03290,0,1,20,58,89,4,27,4,0,113,11,60,274785,124,31,4,147,1
22,406,03291,0,2,40,76,28,17,18,0,0,75,25,80,228358,100,35,0,104,2
22,406,03292,0,2,153,36,21,1,29,0,0,48,13,273,248998,61,30,0,57,2
22,406,03293,0,1,30,54,19,29,9,3,0,48,8,38,177600,56,38,3,73,1
22,406,03294,0,0,0,80,6,13,37,0,0,61,7,61,281252,68,50,0,86,0
22,406,03295,0,2,0,36,2,3,8,1,0,41,8,0,295821,49,11,1,38,2
22,406,03296,0,1,2,96,5,34,2,1,0,88,7,4,297713,95,36,1,101,1
22,406,03297,0,0,0,34,80,6,16,0,0,38,4,54,156721,42,22,0,114,0
22,407,03298,0,2,110,46,48,2,18,16,0,34,17,130,227198,51,20,16,94,2
22,407,03299,0,1,0,60,25,4,5,1,0,74,4,10,187001,78,9,1,85,1
22,407,03300,0,1,30,48,22,12,6,5,0,33,1,40,152191,34,18,5,70,1
22,407,03301,0,2,30,60,26,6,16,4,0,50,4,120,255810,54,22,4,86,2
22,408,03302,0,2,30,80,22,18,5,4,0,59,19,73,175972,78,23,4,102,2
22,408,03303,0,1,30,47,17,7,4,4,0,48,10,42,191984,58,11,4,64,1
22,408,03304,0,1,30,110,49,16,6,6,0,53,9,30,208013,62,22,6,159,1
22,408,03305,0,1,280,109,124,15,21,10,0,46,47,320,363352,93,36,10,233,1
22,408,03306,0,0,0,73,0,13,21,0,0,45,1,35,178447,46,34,0,73,0
22,408,03307,0,1,30,86,35,19,6,1,0,41,7,60,134731,48,25,1,121,1
22,408,03308,0,0,0,62,0,6,0,0,0,39,0,0,86946,39,6,0,62,0
22,408,03309,0,0,0,61,0,10,0,0,0,44,0,0,88574,44,10,0,61,0
22,408,03310,0,0,0,76,68,3,6,0,0,42,10,30,108265,52,9,0,144,0
22,409,03311,0,2,32,42,137,14,13,3,0,43,11,122,197060,54,27,3,179,2
22,409,03312,0,1,100,44,50,7,5,4,0,56,23,100,215565,79,12,4,94,1
22,409,03313,0,3,24,23,24,15,7,3,0,33,23,31,117486,56,22,3,47,3
22,409,03314,0,1,30,25,12,6,1,1,0,23,3,35,78192,26,7,1,37,1
22,409,03315,0,1,30,183,25,30,2,2,0,54,5,30,187375,59,32,2,208,1
22,409,03316,0,7,101,55,66,18,9,9,0,60,42,131,234836,102,27,9,121,7
22,409,03317,0,2,360,156,225,50,78,48,0,69,625,844,478254,694,128,48,381,2
22,409,03318,0,1,10,56,19,36,2,2,0,73,16,60,222194,89,38,2,75,1
22,409,03319,0,2,60,74,39,12,7,6,0,67,7,60,204752,74,19,6,113,2
22,409,03320,0,0,0,132,38,52,6,0,0,81,7,25,197389,88,58,0,170,0
22,409,03321,0,1,30,50,24,25,5,3,0,28,5,30,125357,33,30,3,74,1
22,409,03322,0,8,246,55,58,5,9,5,0,46,34,252,155370,80,14,5,113,8
22,409,03323,0,1,30,56,18,11,2,2,0,47,1,30,143225,48,13,2,74,1
22,410,03324,0,1,10,54,64,8,13,3,0,65,13,20,206021,78,21,3,118,1
22,410,03325,0,1,30,52,38,9,13,8,0,46,123,35,203295,169,22,8,90,1
22,410,03326,0,3,46,44,51,6,46,20,0,39,25,184,249728,64,52,20,95,3
22,410,03327,0,1,20,79,12,13,1,1,0,56,8,20,202179,64,14,1,91,1
22,410,03328,0,1,6,65,24,12,5,3,0,60,17,6,217651,77,17,3,89,1
22,410,03329,0,2,30,50,11,6,5,2,0,49,11,42,226432,60,11,2,61,2
22,410,03330,0,1,30,58,18,19,4,4,0,85,15,30,314489,100,23,4,76,1
22,410,03331,0,2,52,51,43,15,14,12,0,75,49,112,242089,124,29,12,94,2
22,410,03332,0,89,655,77,1834,41,272,207,0,59,318,777,1366134,377,313,207,1911,89
22,410,03333,0,2,26,41,35,9,5,5,0,39,11,26,167652,50,14,5,76,2
22,410,03334,0,2,98,56,99,14,21,8,0,62,45,124,238157,107,35,8,155,2
22,410,03335,0,1,50,46,45,6,7,2,0,44,16,67,94839,60,13,2,91,1
22,410,03336,0,1,30,55,25,4,3,3,0,76,5,32,116208,81,7,3,80,1
22,410,03337,0,0,0,54,0,3,0,0,0,57,0,0,124209,57,3,0,54,0
22,410,03338,0,0,0,52,0,7,0,0,0,29,0,0,94176,29,7,0,52,0
22,411,03339,0,1,30,67,17,21,5,2,0,51,12,54,175617,63,26,2,84,1
22,411,03340,0,1,30,68,38,11,6,0,0,57,4,60,194856,61,17,0,106,1
22,411,03341,0,2,104,101,53,15,16,16,0,59,8,104,264047,67,31,16,154,2
22,411,03342,0,1,10,106,9,11,9,4,0,64,4,24,204551,68,20,4,115,1
22,411,03343,0,1,30,77,104,30,19,4,0,79,12,160,193290,91,49,4,181,1
22,412,03344,0,2,30,67,69,14,54,5,0,76,25,36,219013,101,68,5,136,2
22,412,03345,0,1,30,61,2,17,2,2,0,43,3,30,121430,46,19,2,63,1
22,412,03346,0,3,420,76,290,15,50,38,0,44,123,461,279601,167,65,38,366,3
22,412,03347,0,1,30,114,285,10,44,38,0,84,15,57,179505,99,54,38,399,1
22,413,03348,0,1,30,92,31,18,6,3,0,44,6,32,106414,50,24,3,123,1
22,413,03349,0,1,30,73,57,11,9,4,0,38,2,30,94919,40,20,4,130,1
22,413,03350,0,0,0,91,0,34,0,0,0,48,0,0,64142,48,34,0,91,0
22,413,03351,0,1,150,50,72,16,38,19,0,37,19,302,123591,56,54,19,122,1
22,413,03352,0,1,30,115,14,24,13,2,0,48,2,30,110424,50,37,2,129,1
22,413,03353,0,1,30,38,54,3,4,0,0,34,8,90,77981,42,7,0,92,1
22,413,03354,0,1,50,75,38,16,5,3,0,45,11,68,170901,56,21,3,113,1
22,414,03355,0,1,30,33,26,11,4,4,0,31,1,30,93003,32,15,4,59,1
22,414,03356,0,1,30,38,28,2,1,1,0,31,1,30,85560,32,3,1,66,1
22,414,03357,0,1,100,73,61,12,10,7,0,61,13,217,201776,74,22,7,134,1
22,414,03358,0,0,0,44,0,10,0,0,0,38,0,0,99714,38,10,0,44,0
22,414,03359,0,1,30,33,23,2,4,4,0,29,1,30,98712,30,6,4,56,1
22,414,03360,0,15,379,128,284,31,132,123,0,49,52,458,239789,101,163,123,412,15
22,414,03361,0,0,0,57,0,10,0,0,0,35,0,0,75802,35,10,0,57,0
22,414,03362,0,0,0,38,0,7,0,0,0,19,0,0,47999,19,7,0,38,0
22,414,03363,0,1,10,103,47,28,8,1,0,59,4,34,163997,63,36,1,150,1
22,414,03364,0,0,0,87,0,20,0,0,0,53,0,0,149790,53,20,0,87,0
22,414,03365,0,0,0,76,0,41,0,0,0,41,0,0,77457,41,41,0,76,0
22,414,03366,0,0,0,51,0,11,0,0,0,38,0,0,79360,38,11,0,51,0
22,415,03367,0,1,100,56,54,6,3,3,0,32,3,118,104753,35,9,3,110,1
22,415,03368,0,0,0,18,0,5,0,0,0,44,0,0,33735,44,5,0,18,0
22,416,03369,0,2,216,23,179,1,35,29,0,22,9,436,94351,31,36,29,202,2
22,416,03370,0,2,40,12,68,0,19,10,0,18,3,88,80552,21,19,10,80,2
22,416,03371,0,0,0,39,0,4,0,0,0,21,0,0,43315,21,4,0,39,0
22,416,03372,0,3,88,26,97,9,12,10,0,10,5,98,65241,15,21,10,123,3
22,416,03373,0,1,8,23,31,3,4,1,0,16,10,38,105384,26,7,1,54,1
22,416,03374,0,0,0,89,0,13,0,0,0,27,0,0,79672,27,13,0,89,0
22,416,03375,0,1,30,26,36,2,5,3,0,18,4,34,64891,22,7,3,62,1
22,417,03376,0,1,6,19,1,4,4,4,0,21,4,10,48910,25,8,4,20,1
22,417,03377,0,0,0,28,0,7,0,0,0,23,0,0,55615,23,7,0,28,0
22,417,03378,0,1,30,24,8,3,21,6,0,23,2,30,66350,25,24,6,32,1
22,417,03379,0,1,30,27,3,4,5,3,0,26,2,40,83194,28,9,3,30,1
23,418,03380,1,0,0,96,0,56,2,0,2,25,1,30,144537,26,58,2,96,1
23,418,03381,4,0,0,71,0,53,0,0,4,30,0,0,87424,30,53,4,71,4
23,418,03382,1,1,100,112,50,73,21,20,2,34,20,100,245865,54,94,22,162,2
23,418,03383,1,0,0,51,21,32,5,0,1,16,13,30,101605,29,37,1,72,1
23,418,03384,1,0,0,79,0,56,0,0,1,27,0,0,108194,27,56,1,79,1
23,419,03385,0,1,58,84,46,39,1,1,0,29,5,58,258689,34,40,1,130,1
23,419,03386,0,0,0,189,4,99,4,0,0,54,3,50,231154,57,103,0,193,0
23,419,03387,0,1,300,159,176,79,54,43,0,59,44,428,625004,103,133,43,335,1
23,419,03388,0,0,0,213,58,98,5,0,0,80,7,30,440253,87,103,0,271,0
23,419,03389,0,0,0,43,21,27,5,0,0,22,16,30,191665,38,32,0,64,0
23,419,03390,0,0,0,34,71,18,14,0,0,12,11,61,219189,23,32,0,105,0
23,420,03391,4,0,0,59,0,41,0,0,9,28,0,0,139378,28,41,9,59,4
23,420,03392,0,1,300,109,101,58,33,12,0,41,26,379,538144,67,91,12,210,1
23,420,03393,2,0,0,72,54,38,8,0,2,34,3,30,198342,37,46,2,126,2
23,420,03394,1,0,0,57,11,21,4,0,0,18,12,6,128774,30,25,0,68,1
23,420,03395,0,0,0,64,23,22,15,0,0,29,31,75,316781,60,37,0,87,0
23,420,03396,1,0,0,47,0,25,0,0,0,20,0,0,77970,20,25,0,47,1
23,420,03397,1,0,0,47,8,14,3,0,0,15,9,10,89442,24,17,0,55,1
23,420,03398,1,0,0,69,27,23,7,0,0,24,45,59,214032,69,30,0,96,1
23,421,03399,0,5,368,704,603,322,89,48,0,313,134,872,1495201,447,411,48,1307,5
23,421,03400,0,1,100,116,71,138,11,0,0,156,98,206,324543,254,149,0,187,1
23,421,03401,0,0,0,75,27,73,5,0,0,76,7,31,108724,83,78,0,102,0
23,421,03402,0,0,0,40,8,41,2,0,0,44,3,6,103226,47,43,0,48,0
23,422,03403,0,1,36,29,32,19,5,0,0,16,5,92,116191,21,24,0,61,1
23,422,03404,0,0,0,26,35,23,4,0,0,34,3,30,136920,37,27,0,61,0
23,422,03405,0,1,200,104,131,78,36,19,0,62,18,247,373669,80,114,19,235,1
23,422,03406,0,0,0,42,23,36,4,0,0,40,16,30,159821,56,40,0,65,0
23,423,03407,4,0,0,120,0,105,0,0,3,61,0,0,207293,61,105,3,120,4
23,423,03408,0,1,300,46,129,44,32,28,0,27,33,361,340689,60,76,28,175,1
23,423,03409,3,0,0,90,18,83,5,0,2,25,1,30,198866,26,88,2,108,3
23,423,03410,0,0,0,42,37,35,5,0,0,15,23,30,194271,38,40,0,79,0
23,423,03411,2,0,0,46,23,46,5,0,2,33,1,30,163163,34,51,2,69,2
23,423,03412,0,0,0,29,15,27,7,0,0,15,33,30,177752,48,34,0,44,0
23,423,03413,0,0,0,71,0,54,5,0,0,27,11,46,259662,38,59,0,71,0
23,423,03414,0,0,0,47,11,47,6,0,0,32,2,30,183870,34,53,0,58,0
23,424,03415,2,0,0,76,116,50,6,0,4,28,11,25,167893,39,56,4,192,2
23,424,03416,0,0,0,31,0,27,2,0,0,14,1,8,47358,15,29,0,31,0
23,424,03417,0,0,0,57,34,47,6,0,0,22,14,42,189453,36,53,0,91,0
23,424,03418,1,0,0,48,22,47,6,0,1,29,34,36,198372,63,53,1,70,1
23,424,03419,0,0,0,42,0,38,0,0,0,18,0,0,88572,18,38,0,42,0
23,424,03420,1,0,0,61,14,50,1,0,1,36,3,30,213498,39,51,1,75,1
23,424,03421,0,0,0,28,34,20,2,0,0,18,1,30,123125,19,22,0,62,0
23,424,03422,0,0,0,24,19,25,1,0,0,22,6,6,114815,28,26,0,43,0
23,424,03423,0,1,200,46,44,42,3,1,0,29,76,230,301541,105,45,1,90,1
23,425,03424,0,0,0,39,36,37,4,0,0,39,6,6,187093,45,41,0,75,0
23,425,03425,0,0,0,19,17,21,1,0,0,15,2,30,99946,17,22,0,36,0
23,425,03426,0,0,0,18,12,14,1,0,0,12,1,6,100601,13,15,0,30,0
23,425,03427,0,0,0,58,77,36,18,0,0,25,18,36,182233,43,54,0,135,0
23,425,03428,0,0,0,49,28,45,4,0,0,15,3,12,105001,18,49,0,77,0
23,425,03429,0,2,300,54,185,52,34,30,0,39,104,455,359293,143,86,30,239,2
23,425,03430,0,0,0,85,32,58,7,0,0,44,10,39,254982,54,65,0,117,0
23,425,03431,0,0,0,21,26,16,4,0,0,13,4,30,110912,17,20,0,47,0
23,425,03432,0,0,0,22,16,30,2,0,0,10,15,30,98517,25,32,0,38,0
23,425,03433,0,0,0,23,164,14,10,0,0,14,21,42,173324,35,24,0,187,0
23,425,03434,0,0,0,9,31,10,2,0,0,5,1,36,90161,6,12,0,40,0
23,426,03435,0,0,0,55,39,38,4,0,0,31,10,36,170451,41,42,0,94,0
23,426,03436,0,1,132,33,123,24,14,14,0,19,2,132,156219,21,38,14,156,1
23,426,03437,0,0,0,8,23,5,7,0,0,4,7,16,88685,11,12,0,31,0
23,426,03438,0,0,0,69,0,29,0,0,0,27,0,0,133492,27,29,0,69,0
23,426,03439,0,0,0,37,6,35,4,0,0,36,13,34,114578,49,39,0,43,0
23,426,03440,0,0,0,42,7,31,4,0,0,31,42,31,167479,73,35,0,49,0
23,426,03441,0,0,0,56,0,18,0,0,0,15,0,0,107583,15,18,0,56,0
23,426,03442,0,0,0,34,0,14,0,0,0,9,0,0,77550,9,14,0,34,0
23,427,03443,0,0,0,22,18,21,9,0,0,23,6,66,196594,29,30,0,40,0
23,427,03444,1,0,0,40,21,30,7,0,1,23,2,30,189158,25,37,1,61,1
23,427,03445,4,0,0,83,0,41,0,0,4,39,0,0,152527,39,41,4,83,4
23,427,03446,0,0,0,32,16,27,7,0,0,21,8,32,202526,29,34,0,48,0
23,427,03447,0,0,0,30,22,28,5,0,0,28,1,36,138052,29,33,0,52,0
23,427,03448,1,0,0,37,17,22,6,0,1,33,2,38,124027,35,28,1,54,1
23,427,03449,4,2,414,173,406,106,71,49,4,94,68,600,822773,162,177,53,579,6
23,427,03450,0,0,0,6,13,6,6,0,0,8,2,35,118370,10,12,0,19,0
23,427,03451,1,0,0,18,24,11,3,0,1,20,10,12,139409,30,14,1,42,1
23,427,03452,1,0,0,46,0,26,0,0,1,48,0,0,116760,48,26,1,46,1
23,427,03453,1,0,0,31,12,23,7,0,1,17,2,36,176807,19,30,1,43,1
23,428,03454,0,0,0,12,33,18,4,0,0,23,11,30,149460,34,22,0,45,0
23,428,03455,0,0,0,49,0,28,0,0,0,35,0,0,124214,35,28,0,49,0
23,428,03456,0,0,0,50,0,30,0,0,0,41,0,0,141359,41,30,0,50,0
23,428,03457,0,0,0,36,15,28,5,0,0,11,3,46,172450,14,33,0,51,0
23,428,03458,0,1,175,9,48,21,48,26,0,18,101,286,359312,119,69,26,57,1
23,428,03459,0,0,0,29,0,29,2,0,0,47,1,30,163696,48,31,0,29,0
23,428,03460,0,0,0,10,22,32,3,0,0,47,13,30,152901,60,35,0,32,0
23,429,03461,0,1,220,94,266,67,36,25,0,31,60,308,503821,91,103,25,360,1
23,429,03462,0,0,0,49,9,29,16,0,0,19,15,60,150110,34,45,0,58,0
23,429,03463,0,0,0,39,15,22,5,0,0,18,12,9,132102,30,27,0,54,0
23,429,03464,0,0,0,90,44,74,3,0,0,34,9,58,232159,43,77,0,134,0
23,429,03465,0,0,0,81,9,50,3,0,0,45,1,30,190609,46,53,0,90,0
23,429,03466,0,0,0,59,0,38,0,0,0,21,0,0,168012,21,38,0,59,0
23,429,03467,0,0,0,41,18,20,1,0,0,18,27,5,107550,45,21,0,59,0
23,429,03468,0,0,0,92,32,54,4,0,0,37,14,60,224647,51,58,0,124,0
23,429,03469,0,0,0,40,0,24,0,0,0,20,0,0,159111,20,24,0,40,0
23,429,03470,0,0,0,169,22,108,8,0,0,79,5,66,358487,84,116,0,191,0
23,430,03471,0,0,0,125,20,77,5,0,0,75,17,40,251410,92,82,0,145,0
23,430,03472,2,0,0,130,0,79,0,0,4,72,0,0,214848,72,79,4,130,2
23,430,03473,2,0,0,83,46,49,7,0,4,36,7,36,196522,43,56,4,129,2
23,430,03474,0,0,0,56,0,36,1,0,0,37,11,30,216264,48,37,0,56,0
23,430,03475,2,0,0,41,9,34,1,0,4,20,4,6,156232,24,35,4,50,2
23,430,03476,1,0,0,64,15,45,2,0,1,37,9,30,254042,46,47,1,79,1
23,430,03477,0,0,0,26,0,18,6,0,0,16,6,40,188932,22,24,0,26,0
23,430,03478,0,0,0,29,91,20,6,0,0,15,2,32,171879,17,26,0,120,0
23,430,03479,1,2,1141,60,477,39,140,136,3,28,47,1271,479333,75,179,139,537,3
23,430,03480,0,0,0,30,0,20,0,0,0,21,0,0,103241,21,20,0,30,0
23,430,03481,0,0,0,34,2,23,2,0,0,18,7,6,127039,25,25,0,36,0
23,431,03482,0,1,100,75,111,48,11,10,0,21,5,140,124440,26,59,10,186,1
23,431,03483,0,0,0,71,14,53,2,0,0,17,1,8,105118,18,55,0,85,0
23,431,03484,0,0,0,152,0,112,0,0,0,52,0,0,228914,52,112,0,152,0
23,431,03485,0,0,0,31,117,23,16,0,0,13,5,33,107659,18,39,0,148,0
23,431,03486,0,0,0,22,82,17,18,0,0,11,7,60,78441,18,35,0,104,0
23,432,03487,4,0,0,109,36,70,7,0,6,32,3,40,140771,35,77,6,145,4
23,432,03488,4,0,0,52,24,38,3,0,4,19,14,42,105123,33,41,4,76,4
23,432,03489,0,1,200,57,58,46,15,15,0,23,70,220,239517,93,61,15,115,1
23,432,03490,2,0,0,35,5,29,1,0,4,18,10,30,72735,28,30,4,40,2
23,432,03491,7,0,0,112,65,83,9,0,9,49,21,123,267380,70,92,9,177,7
23,433,03492,1,0,0,111,42,68,2,0,2,27,20,59,151295,47,70,2,153,1
23,433,03493,6,0,0,132,17,93,10,0,8,48,16,68,203907,64,103,8,149,6
23,433,03494,1,0,0,81,0,54,7,0,2,25,21,72,135181,46,61,2,81,1
23,433,03495,0,0,0,51,17,39,2,0,0,16,16,30,125848,32,41,0,68,0
23,433,03496,2,3,599,84,146,60,26,26,4,30,21,739,336321,51,86,30,230,5
23,433,03497,4,0,0,73,0,57,2,0,7,28,1,10,109572,29,59,7,73,4
23,433,03498,3,0,0,76,2,52,1,0,5,22,1,30,189814,23,53,5,78,3
23,433,03499,0,0,0,33,18,25,4,0,0,13,5,30,88388,18,29,0,51,0
23,434,03500,1,0,0,46,2,26,3,0,0,21,1,30,138362,22,29,0,48,1
23,434,03501,1,0,0,29,42,28,11,0,0,20,19,126,243070,39,39,0,71,1
23,434,03502,3,0,0,28,22,34,4,0,0,21,4,39,111970,25,38,0,50,3
23,434,03503,4,0,0,24,18,31,4,0,3,18,6,34,106988,24,35,3,42,4
23,434,03504,5,0,0,91,7,55,4,0,3,41,5,33,134690,46,59,3,98,5
23,434,03505,1,0,0,13,0,24,0,0,0,21,0,0,80222,21,24,0,13,1
23,434,03506,2,0,0,19,0,21,0,0,4,17,0,0,84125,17,21,4,19,2
23,434,03507,5,2,611,59,534,61,32,25,4,38,47,747,555210,85,93,29,593,7
23,435,03508,0,0,0,18,30,24,2,0,0,16,4,20,161232,20,26,0,48,0
23,435,03509,0,0,77.77777862548828,11,35,14,14.66666603088379,5.222222328186035,0,9,14,144.8888854980469,237996,23,28.666666,5.2222223,46,0
23,435,03510,2,0,0,45,37,29,5,0,0,27,8,44,259229,35,34,0,82,2
23,435,03511,3,0,0,40,0,23,0,0,0,22,0,0,138861,22,23,0,40,3
23,435,03512,1,0,0,41,24,24,8,0,1,25,3,71,247236,28,32,1,65,1
23,435,03513,0,1,700,24,430,28,65,47,0,20,28,966,672566,48,93,47,454,1
23,435,03514,1,0,0,42,58,39,16,0,1,19,7,100,269468,26,55,1,100,1
23,436,03515,0,0,0,24,16,14,4,0,0,7,2,40,143828,9,18,0,40,0
23,436,03516,0,0,0,10,20,10,8,0,0,12,10,51,118592,22,18,0,30,0
23,436,03517,0,0,0,7,50,15,2,0,0,11,1,30,135523,12,17,0,57,0
23,436,03518,0,0,0,10,26,11,18,0,0,11,18,185,173335,29,29,0,36,0
23,436,03519,0,2,166,19,39,21,25,18,0,13,30,216,251766,43,46,18,58,2
23,436,03520,0,0,0,30,0,30,0,0,0,17,0,0,133807,17,30,0,30,0
23,436,03521,0,0,0,30,0,14,0,0,0,15,0,0,115181,15,14,0,30,0
23,436,03522,0,2,104,7,68,17,20,13,0,14,66,146,239116,80,37,13,75,2
23,436,03523,0,0,0,62,25,31,0,0,0,21,11,30,201344,32,31,0,87,0
23,437,03524,0,0,0,70,86,30,7,0,0,29,1,30,133783,30,37,0,156,0
23,437,03525,0,0,0,89,9,42,13,0,0,26,19,79,172286,45,55,0,98,0
23,437,03526,0,1,300,138,302,61,34,33,0,31,30,300,505884,61,95,33,440,1
23,437,03527,0,0,0,58,22,20,7,0,0,14,7,42,112386,21,27,0,80,0
23,437,03528,0,0,0,59,22,21,16,0,0,18,6,36,146077,24,37,0,81,0
23,437,03529,0,0,0,92,135,45,16,0,0,28,4,55,194946,32,61,0,227,0
23,437,03530,0,0,0,83,6,38,5,0,0,20,9,10,106398,29,43,0,89,0
23,437,03531,0,0,0,99,16,40,4,0,0,28,6,40,191396,34,44,0,115,0
23,438,03532,0,0,0,66,35,30,9,0,0,21,4,30,226418,25,39,0,101,0
23,438,03533,0,0,0,163,20,95,11,0,0,70,3,40,296513,73,106,0,183,0
23,438,03534,0,2,151.8461542129517,236,43,118,44.84615421295166,16.15384614467621,0,69,74,352.538459777832,578010,143,162.84616,16.153847,279,2
23,438,03535,0,0,0,133,0,52,0,0,0,47,0,0,156006,47,52,0,133,0
23,438,03536,0,0,0,259,47,152,10,0,0,90,3,68,322215,93,162,0,306,0
23,438,03537,0,0,0,107,12,81,4,0,0,52,1,44,114242,53,85,0,119,0
23,438,03538,0,0,0,173,84,85,13,0,0,63,4,32,308147,67,98,0,257,0
23,438,03539,0,0,0,101,62,42,15,0,0,31,17,71,183516,48,57,0,163,0
23,439,03540,0,0,0,51,68,40,21,0,0,34,18,93,228101,52,61,0,119,0
23,439,03541,0,0,0,19,33,14,7,0,0,16,10,26,97338,26,21,0,52,0
23,439,03542,0,0,0,75,17,64,9,0,0,64,7,54,197799,71,73,0,92,0
23,439,03543,2,0,0,79,67,63,12,0,2,57,45,53,397016,102,75,2,146,2
23,439,03544,1,3,300,115,167,90,81,69,3,64,14,392,361833,78,171,72,282,4
23,440,03545,3,2,100,55,72,46,19,12,2,31,23,138,357070,54,65,14,127,5
23,440,03546,3,0,0,101,54,84,7,0,3,72,8,70,232916,80,91,3,155,3
23,440,03547,3,0,0,52,36,75,7,0,4,38,5,33,242551,43,82,4,88,3
23,440,03548,0,0,0,84,0,65,0,0,0,36,0,0,83487,36,65,0,84,0
23,440,03549,1,0,0,51,12,46,2,0,1,36,1,36,191706,37,48,1,63,1
23,440,03550,2,1,300,102,275,69,47,30,1,56,69,390,246382,125,116,31,377,3
23,440,03551,5,0,0,120,25,70,4,0,2,45,1,54,123419,46,74,2,145,5
23,440,03552,1,0,0,95,0,73,0,0,0,47,0,0,192949,47,73,0,95,1
23,440,03553,3,0,0,37,0,44,0,0,0,37,0,0,201696,37,44,0,37,3
23,441,03554,0,1,262,90,228,64,35,25,0,42,38,368,211041,80,99,25,318,1
23,441,03555,0,0,0,186,0,105,0,0,0,48,0,0,162432,48,105,0,186,0
23,441,03556,0,0,0,41,0,20,0,0,0,24,0,0,79017,24,20,0,41,0
23,441,03557,0,0,0,38,38,20,4,0,0,13,4,11,89465,17,24,0,76,0
23,441,03558,0,0,0,226,23,113,4,0,0,61,4,40,213216,65,117,0,249,0
23,441,03559,0,0,0,57,73,41,9,0,0,29,5,43,157975,34,50,0,130,0
23,441,03560,0,0,0,70,0,49,0,0,0,31,0,0,112639,31,49,0,70,0
23,441,03561,0,1,46,96,16,69,7,5,0,40,51,55,231318,91,76,5,112,1
23,441,03562,0,0,0,95,0,43,0,0,0,27,0,0,128721,27,43,0,95,0
23,442,03563,0,0,0,100,25,66,3,0,0,45,3,38,199498,48,69,0,125,0
23,442,03564,0,0,0,58,33,42,7,0,0,26,8,44,190894,34,49,0,91,0
23,442,03565,0,1,300,47,184,40,26,14,0,26,27,348,239540,53,66,14,231,1
23,442,03566,0,1,100,70,88,48,13,3,0,38,14,137,280513,52,61,3,158,1
23,442,03567,0,0,0,44,24,32,14,0,0,28,4,60,186082,32,46,0,68,0
23,442,03568,0,0,0,78,48,57,9,0,0,55,7,90,278052,62,66,0,126,0
23,442,03569,0,0,0,50,9,33,3,0,0,15,6,18,170463,21,36,0,59,0
23,443,03570,0,0,0,64,35,44,1,0,0,19,16,50,143555,35,45,0,99,0
23,443,03571,0,1,60,71,46,54,8,7,0,26,14,70,234204,40,62,7,117,1
23,443,03572,0,0,0,82,63,49,4,0,0,23,1,50,158747,24,53,0,145,0
23,443,03573,0,1,100,59,86,52,20,14,0,27,19,140,215958,46,72,14,145,1
23,443,03574,0,0,0,35,0,19,0,0,0,10,0,0,69109,10,19,0,35,0
23,443,03575,0,0,0,34,0,27,0,0,0,13,0,0,82718,13,27,0,34,0
23,443,03576,0,0,0,37,20,22,6,0,0,11,2,38,108494,13,28,0,57,0
23,443,03577,0,0,0,33,0,17,0,0,0,10,0,0,68955,10,17,0,33,0
23,443,03578,0,0,0,22,0,12,0,0,0,4,0,0,54090,4,12,0,22,0
23,443,03579,0,1,300,53,159,38,32,24,0,16,24,341,321968,40,70,24,212,1
23,444,03580,1,0,0,85,72,71,24,0,2,50,6,57,263433,56,95,2,157,1
23,444,03581,0,15,1610,54,4600,41,525,240,0,35,1171,4176,2107275,1206,566,240,4654,15
23,445,03582,0,1,200,39,130,37,29,28,0,44,11,244,274989,55,66,28,169,1
23,445,03583,1,0,0,73,0,65,0,0,1,25,0,0,152335,25,65,1,73,1
23,445,03584,0,0,0,120,67,115,9,0,0,35,4,72,253353,39,124,0,187,0
23,445,03585,0,0,0,63,7,68,3,0,0,25,2,12,108436,27,71,0,70,0
23,445,03586,3,0,0,102,55,119,5,0,4,53,2,31,162233,55,124,4,157,3
23,445,03587,4,0,0,91,43,97,6,0,5,42,3,50,176215,45,103,5,134,4
23,445,03588,1,0,0,51,42,46,2,0,1,21,2,34,91906,23,48,1,93,1
23,445,03589,0,0,0,59,7,56,3,0,0,24,3,12,91447,27,59,0,66,0
23,446,03590,0,2,180,52,160,36,32,26,0,27,34,245,225998,61,68,26,212,2
23,446,03591,1,0,0,35,2,20,3,0,2,14,1,35,124957,15,23,2,37,1
23,446,03592,0,0,0,15,54,11,5,0,0,9,3,30,146121,12,16,0,69,0
23,446,03593,1,0,0,68,53,46,12,0,1,40,29,56,268733,69,58,1,121,1
23,446,03594,0,0,0,16,46,11,9,0,0,12,4,13,142212,16,20,0,62,0
23,446,03595,1,0,0,23,19,14,1,0,1,12,3,16,111567,15,15,1,42,1
23,446,03596,0,0,0,59,13,42,3,0,0,21,10,50,154617,31,45,0,72,0
23,446,03597,0,0,0,53,36,36,3,0,0,25,3,30,156117,28,39,0,89,0
23,447,03598,0,0,0,109,77,75,3,0,0,85,11,31,289150,96,78,0,186,0
23,447,03599,0,0,0,27,20,12,4,0,0,28,10,41,106743,38,16,0,47,0
23,447,03600,0,2,300,104,166,66,22,19,0,59,18,348,280102,77,88,19,270,2
23,447,03601,0,0,0,13,28,21,3,0,0,14,2,30,86761,16,24,0,41,0
23,447,03602,0,0,0,82,185,52,33,0,0,42,12,196,235741,54,85,0,267,0
23,447,03603,0,0,0,160,0,111,0,0,0,85,5,0,113183,90,111,0,160,0
23,447,03604,0,0,0,124,20,39,4,0,0,62,3,30,286833,65,43,0,144,0
23,447,03605,0,1,20,12,38,15,4,3,0,30,6,26,176008,36,19,3,50,1
23,448,03606,0,0,0,18,32,22,5,0,0,24,8,30,89919,32,27,0,50,0
23,448,03607,0,0,0,10,0,11,0,0,0,9,0,0,82090,9,11,0,10,0
23,448,03608,0,1,100,9,73,18,12,11,0,29,4,130,153814,33,30,11,82,1
23,448,03609,0,0,0,8,0,10,0,0,0,22,0,0,71418,22,10,0,8,0
23,448,03610,0,0,0,30,36,28,4,0,0,27,5,30,76705,32,32,0,66,0
23,448,03611,0,0,0,10,0,9,0,0,0,14,0,0,95893,14,9,0,10,0
23,449,03612,1,0,0,19,37,17,6,0,0,34,12,40,186700,46,23,0,56,1
23,449,03613,0,0,0,19,125,22,24,0,0,31,9,215,240656,40,46,0,144,0
23,449,03614,0,1,360,11,155,4,19,12,0,9,17,441,165749,26,23,12,166,1
23,449,03615,1,0,0,10,0,5,0,0,0,17,0,0,57603,17,5,0,10,1
23,449,03616,0,0,0,1,20,9,2,0,0,27,17,32,134364,44,11,0,21,0
23,449,03617,1,0,0,20,51,11,6,0,2,18,2,30,149184,20,17,2,71,1
23,449,03618,2,1,18,14,86,9,11,2,1,24,16,56,181242,40,20,3,100,3
23,449,03619,1,0,0,25,0,13,0,0,0,24,0,0,125630,24,13,0,25,1
23,450,03620,2,1,172,40,230,23,29,25,1,34,84,182,369412,118,52,26,270,3
23,450,03621,2,0,0,48,0,32,0,0,3,30,0,0,127044,30,32,3,48,2
23,450,03622,0,0,0,25,15,8,3,0,0,14,8,36,103476,22,11,0,40,0
23,450,03623,0,0,0,11,0,11,0,0,0,15,0,0,104099,15,11,0,11,0
23,450,03624,0,1,60,14,78,11,8,5,0,27,7,78,210861,34,19,5,92,1
23,450,03625,4,0,0,31,0,24,0,0,3,35,0,0,198822,35,24,3,31,4
23,450,03626,2,0,0,50,0,27,0,0,1,39,0,0,177603,39,27,1,50,2
23,451,03627,0,1,60,43,37,27,11,9,0,28,14,71,179576,42,38,9,80,1
23,451,03628,0,0,0,32,6,27,2,0,0,41,8,40,169194,49,29,0,38,0
23,451,03629,0,0,0,37,37,30,7,0,0,32,12,36,163528,44,37,0,74,0
23,451,03630,0,0,0,39,0,26,0,0,0,62,2,0,191664,64,26,0,39,0
23,451,03631,0,2,50,15,307,14,29,10,0,25,25,182,301286,50,43,10,322,2
23,451,03632,0,1,75,21,83,15,19,12,0,32,5,110,252206,37,34,12,104,1
23,451,03633,0,0,0,17,45,13,22,0,0,23,13,34,123416,36,35,0,62,0
23,452,03634,0,0,0,5,11,11,6,0,0,61,8,35,195853,69,17,0,16,0
23,452,03635,0,0,0,53,58,61,22,0,0,160,14,76,421061,174,83,0,111,0
23,452,03636,0,1,200,40,148,37,20,18,0,36,16,259,219311,52,57,18,188,1
23,452,03637,0,0,0,11,46,11,8,0,0,57,9,43,159862,66,19,0,57,0
23,452,03638,0,0,0,17,13,9,2,0,0,13,2,30,94736,15,11,0,30,0
23,453,03639,0,0,0,30,64,15,3,0,0,54,7,40,216882,61,18,0,94,0
23,453,03640,0,1,100,74,59,77,5,5,0,157,10,100,487289,167,82,5,133,1
23,454,03641,0,0,0,21,10,38,3,0,0,29,4,30,124534,33,41,0,31,0
23,454,03642,0,0,0,22,0,10,0,0,0,49,0,0,108777,49,10,0,22,0
23,454,03643,0,1,300,65,224,32,42,29,0,77,17,387,232751,94,74,29,289,1
23,454,03644,1,0,0,39,0,35,0,0,1,73,0,0,172823,73,35,1,39,1
23,454,03645,0,0,0,45,1,43,2,0,0,58,2,30,258230,60,45,0,46,0
23,454,03646,0,0,0,35,94,31,12,0,0,47,16,60,157354,63,43,0,129,0
23,455,03647,2,0,0,69,0,40,0,0,3,22,0,0,113969,22,40,3,69,2
23,455,03648,0,0,0,26,50,13,11,0,0,29,21,116,159022,50,24,0,76,0
23,455,03649,1,0,0,4,32,3,3,0,0,15,7,30,135166,22,6,0,36,1
23,455,03650,1,0,0,41,43,22,3,0,0,36,4,44,189358,40,25,0,84,1
23,455,03651,1,0,0,29,20,36,5,0,6,32,5,60,240464,37,41,6,49,1
23,455,03652,0,0,0,14,143,13,53,0,0,21,34,136,193483,55,66,0,157,0
23,455,03653,1,0,0,16,0,21,0,0,1,17,0,0,91411,17,21,1,16,1
23,455,03654,0,1,400,40,362,24,42,30,0,34,45,662,337124,79,66,30,402,1
23,455,03655,1,0,0,25,0,31,0,0,0,31,0,0,168298,31,31,0,25,1
23,455,03656,3,0,0,53,66,12,23,0,1,34,40,124,181602,74,35,1,119,3
23,455,03657,1,0,0,69,0,18,0,0,1,18,0,0,87660,18,18,1,69,1
23,455,03658,0,0,0,44,54,24,11,0,0,28,21,39,192256,49,35,0,98,0
23,456,03659,0,0,0,23,21,23,8,0,0,40,5,30,208150,45,31,0,44,0
23,456,03660,0,0,0,21,43,28,2,0,0,31,1,30,123024,32,30,0,64,0
23,456,03661,0,0,0,22,28,9,3,0,0,27,2,30,142633,29,12,0,50,0
23,456,03662,0,0,0,30,0,18,0,0,0,30,0,0,85066,30,18,0,30,0
23,456,03663,1,0,0,41,38,31,1,0,0,54,9,30,158179,63,32,0,79,1
23,456,03664,1,1,245,63,187,36,23,18,0,65,26,275,347427,91,59,18,250,2
23,456,03665,0,0,0,25,36,10,2,0,0,75,5,40,197535,80,12,0,61,0
23,456,03666,0,0,0,32,0,13,0,0,0,24,0,0,116803,24,13,0,32,0
23,457,03667,1,0,0,28,44,10,4,0,1,15,3,30,102594,18,14,1,72,1
23,457,03668,0,0,0,19,11,10,1,0,0,9,11,6,79299,20,11,0,30,0
23,457,03669,0,0,0,36,33,22,9,0,0,25,5,74,176291,30,31,0,69,0
23,457,03670,2,0,0,45,0,18,0,0,0,26,0,0,147208,26,18,0,45,2
23,457,03671,0,0,0,38,0,17,0,0,0,24,0,0,170849,24,17,0,38,0
23,457,03672,3,1,300,32,179,37,37,26,3,46,24,330,269290,70,74,29,211,4
23,457,03673,1,0,0,22,10,23,6,0,0,38,5,30,175845,43,29,0,32,1
23,457,03674,3,0,0,37,45,21,7,0,0,45,8,80,284265,53,28,0,82,3
23,457,03675,2,0,0,5,3,13,1,0,0,34,1,6,107858,35,14,0,8,2
23,457,03676,4,0,0,26,24,13,4,0,2,42,29,30,187537,71,17,2,50,4
23,458,03677,0,1,270,82,166,52,38,34,0,70,82,310,405288,152,90,34,248,1
23,458,03678,0,0,0,74,0,57,0,0,0,41,0,0,172075,41,57,0,74,0
23,458,03679,0,0,0,27,10,24,4,0,0,21,11,30,160290,32,28,0,37,0
23,458,03680,0,0,0,35,0,23,0,0,0,21,0,0,117967,21,23,0,35,0
23,458,03681,0,0,0,15,16,10,3,0,0,21,21,30,118750,42,13,0,31,0
23,458,03682,0,0,0,30,34,31,3,0,0,19,2,30,139428,21,34,0,64,0
23,458,03683,0,0,0,33,15,28,8,0,0,30,2,22,127364,32,36,0,48,0
23,459,03684,0,0,0,45,22,24,2,0,0,54,2,30,176102,56,26,0,67,0
23,459,03685,0,0,0,29,36,15,3,0,0,27,5,60,158266,32,18,0,65,0
23,459,03686,0,1,100,22,50,12,14,12,0,15,21,100,215129,36,26,12,72,1
23,459,03687,0,0,0,22,0,13,0,0,0,18,0,0,73577,18,13,0,22,0
23,459,03688,0,0,0,64,15,53,2,0,0,35,5,30,221372,40,55,0,79,0
23,460,03689,1,0,0,50,38,53,4,0,1,26,7,60,223321,33,57,1,88,1
23,460,03690,1,0,0,39,39,42,11,0,1,23,6,71,193184,29,53,1,78,1
23,460,03691,1,1,300,101,177,70,36,20,1,38,53,490,466087,91,106,21,278,2
23,460,03692,0,0,0,70,0,48,0,0,0,31,0,0,162415,31,48,0,70,0
23,461,03693,0,0,0,14,36,16,4,0,0,9,5,36,120533,14,20,0,50,0
23,461,03694,0,1,100,52,61,67,41,19,0,44,17,157,305852,61,108,19,113,1
23,461,03695,0,0,0,43,10,40,2,0,0,24,5,30,92822,29,42,0,53,0
23,461,03696,0,0,0,69,14,57,4,0,0,57,3,12,229918,60,61,0,83,0
23,462,03697,0,0,0,10,32,6,2,0,0,8,3,40,206331,11,8,0,42,0
23,462,03698,0,0,0,18,65,12,15,0,0,8,7,115,116893,15,27,0,83,0
23,462,03699,0,1,162,19,136,15,22,18,0,36,16,192,289474,52,37,18,155,1
23,462,03700,0,0,0,36,0,22,0,0,0,50,0,0,268531,50,22,0,36,0
23,462,03701,0,0,0,29,27,31,1,0,0,25,1,30,163811,26,32,0,56,0
23,462,03702,0,0,0,11,0,9,0,0,0,13,0,0,81106,13,9,0,11,0
23,463,03703,0,0,0,76,0,46,0,0,0,43,1,0,336548,44,46,0,76,0
23,463,03704,0,0,0,77,0,43,0,0,0,37,0,0,324198,37,43,0,77,0
23,463,03705,0,1,200,55,53,35,14,4,0,38,10,230,517118,48,49,4,108,1
23,464,03706,0,0,0,31,43,24,5,0,0,37,2,50,182362,39,29,0,74,0
23,464,03707,0,0,0,73,54,49,7,0,0,46,1,65,232667,47,56,0,127,0
23,464,03708,0,0,0,44,21,37,2,0,0,51,3,30,171944,54,39,0,65,0
23,464,03709,0,2,200,66,59,40,26,19,0,57,6,250,323143,63,66,19,125,2
23,464,03710,0,0,0,39,29,38,2,0,0,30,2,30,114738,32,40,0,68,0
23,465,03711,0,0,0,27,10,19,3,0,0,17,6,30,91101,23,22,0,37,0
23,465,03712,0,0,0,33,0,23,1,0,0,35,3,30,191359,38,24,0,33,0
23,465,03713,0,1,100,90,73,70,16,15,0,68,20,107,446402,88,86,15,163,1
23,466,03714,1,0,0,28,68,23,5,0,0,27,2,30,127199,29,28,0,96,1
23,466,03715,0,0,0,39,0,36,0,0,0,60,0,0,222512,60,36,0,39,0
23,466,03716,0,1,400,82,0,73,49,47,0,65,19,580,558022,84,122,47,82,1
23,466,03717,0,0,0,31,36,23,6,0,0,38,11,54,236806,49,29,0,67,0
23,466,03718,0,0,0,23,28,15,3,0,0,27,1,30,165490,28,18,0,51,0
23,467,03719,2,1,200,47,163,43,20,12,1,49,51,396,433493,100,63,13,210,3
23,467,03720,2,0,0,28,0,91,0,0,0,79,0,0,133269,79,91,0,28,2
23,467,03721,2,0,0,50,29,87,2,0,1,74,22,40,190994,96,89,1,79,2
24,468,03722,0,0,0,15,0,8,0,0,0,29,0,0,62535,29,8,0,15,0
24,468,03723,0,0,0,73,30,7,8,0,0,68,6,30,217315,74,15,0,103,0
24,468,03724,0,1,120,65,108,9,33,18,0,54,10,145,185991,64,42,18,173,1
24,468,03725,0,1,65,38,56,5,19,13,0,27,9,93,235478,36,24,13,94,1
24,468,03726,0,2,320,47,185,19,46,23,0,56,46,364,443144,102,65,23,232,2
24,468,03727,1,0,0,91,0,15,0,0,1,52,0,0,146317,52,15,1,91,1
24,468,03728,0,0,0,77,0,12,0,0,0,60,0,0,117449,60,12,0,77,0
24,468,03729,1,1,81,84,31,16,24,4,2,62,17,316,203364,79,40,6,115,2
24,468,03730,5,1,50,31,18,2,16,5,0,31,10,66,153219,41,18,5,49,6
24,468,03731,0,2,125,7,50,2,33,15,0,7,60,155,327166,67,35,15,57,2
24,469,03732,0,0,0,53,0,44,0,0,0,60,0,0,246156,60,44,0,53,0
24,469,03733,0,1,50,47,17,44,11,4,0,71,10,59,327289,81,55,4,64,1
24,469,03734,0,1,200,54,24,5,11,6,0,32,15,220,230741,47,16,6,78,1
24,469,03735,0,0,0,16,0,3,0,0,0,15,0,0,115221,15,3,0,16,0
24,469,03736,0,0,0,9,0,9,0,0,0,32,0,0,132354,32,9,0,9,0
24,469,03737,0,1,31,32,27,11,9,4,0,48,6,53,224839,54,20,4,59,1
24,469,03738,0,0,0,28,10,26,4,0,0,46,3,6,240326,49,30,0,38,0
24,469,03739,0,1,200,29,77,11,40,16,0,57,89,257,438725,146,51,16,106,1
24,469,03740,0,1,150,36,43,36,12,2,0,72,33,165,588123,105,48,2,79,1
24,469,03741,0,1,20,2,8,3,8,2,0,23,5,27,177919,28,11,2,10,1
24,469,03742,0,1,30,3,12,5,4,2,0,15,19,47,123152,34,9,2,15,1
24,469,03743,0,1,50,15,23,8,8,4,0,51,6,65,275608,57,16,4,38,1
24,470,03744,0,0,0,24,0,8,0,0,0,35,0,0,128791,35,8,0,24,0
24,470,03745,0,1,76,26,26,4,8,2,0,30,9,88,144266,39,12,2,52,1
24,470,03746,0,2,90,22,15,9,15,5,0,28,20,100,213087,48,24,5,37,2
24,470,03747,0,1,175,58,67,30,30,14,0,75,51,202,449480,126,60,14,125,1
24,470,03748,0,0,0,15,4,2,5,0,0,16,1,10,94562,17,7,0,19,0
24,470,03749,0,0,0,36,0,12,0,0,0,43,0,0,182805,43,12,0,36,0
24,470,03750,0,1,4,28,16,8,11,2,0,29,6,28,130743,35,19,2,44,1
24,471,03751,0,0,0,15,0,12,0,0,0,20,0,0,89546,20,12,0,15,0
24,471,03752,0,0,0,25,25,4,7,0,0,21,4,21,133778,25,11,0,50,0
24,471,03753,0,1,130,44,13,9,41,35,0,32,19,139,175539,51,50,35,57,1
24,471,03754,0,1,145,52,70,10,23,11,0,44,34,219,262246,78,33,11,122,1
24,471,03755,0,1,100,33,26,6,9,5,0,24,9,110,145445,33,15,5,59,1
24,471,03756,0,1,30,59,33,10,38,29,0,57,17,47,257699,74,48,29,92,1
24,471,03757,0,1,243,102,199,15,40,2,0,73,35,375,529816,108,55,2,301,1
24,471,03758,0,1,50,25,15,5,3,2,0,24,5,50,99588,29,8,2,40,1
24,471,03759,0,1,77,79,38,13,21,2,0,57,35,88,341407,92,34,2,117,1
24,472,03760,0,1,25,125,16,14,15,3,0,58,7,76,293143,65,29,3,141,1
24,472,03761,0,1,30,8,49,8,13,2,0,35,4,99,103895,39,21,2,57,1
24,472,03762,0,0,0,5,6,1,3,0,0,20,3,9,92357,23,4,0,11,0
24,472,03763,5,1,50,59,9,48,8,4,6,105,21,68,257866,126,56,10,68,6
24,472,03764,10,0,0,113,16,55,4,0,10,103,5,0,239145,108,59,10,129,10
24,472,03765,4,0,0,49,3,12,3,0,1,39,4,10,167109,43,15,1,52,4
24,472,03766,1,1,300,90,22,20,26,7,1,57,21,346,325639,78,46,8,112,2
24,472,03767,2,1,20,78,39,9,13,3,2,33,6,54,161279,39,22,5,117,3
24,472,03768,0,1,50,25,28,13,9,5,0,31,9,63,154424,40,22,5,53,1
24,472,03769,0,0,0,36,8,8,5,0,0,17,12,13,222625,29,13,0,44,0
24,472,03770,0,0,0,10,0,11,0,0,0,25,0,0,106733,25,11,0,10,0
24,472,03771,3,0,0,36,2,5,2,0,3,20,2,4,97796,22,7,3,38,3
24,472,03772,0,0,0,87,9,12,6,0,0,43,11,4,206391,54,18,0,96,0
24,473,03773,0,2,259,63,80,16,28,12,0,66,46,293,356127,112,44,12,143,2
24,473,03774,1,1,66,94,21,22,9,6,0,45,3,81,206567,48,31,6,115,2
24,473,03775,0,2,172,80,95,9,94,55,0,66,86,220,560497,152,103,55,175,2
24,473,03776,0,0,0,75,17,10,6,0,0,47,10,17,268562,57,16,0,92,0
24,474,03777,1,0,0,17,0,13,0,0,1,40,0,0,70331,40,13,1,17,1
24,474,03778,2,0,0,40,0,23,0,0,2,39,0,0,83199,39,23,2,40,2
24,474,03779,0,1,60,36,42,0,8,6,0,25,6,75,193283,31,8,6,78,1
24,474,03780,0,1,30,38,10,8,5,3,0,36,15,40,237845,51,13,3,48,1
24,474,03781,0,5,42312,0,2015,0,554,339,0,0,1369,42839,5585528,1369,554,339,2015,5
24,474,03782,0,0,0,133,20,5,10,0,0,38,21,28,265830,59,15,0,153,0
24,474,03783,0,1,10,36,41,8,19,4,0,37,12,26,249852,49,27,4,77,1
24,474,03784,0,1,35,14,15,18,10,5,0,23,7,40,158191,30,28,5,29,1
24,474,03785,0,1,15,0,6,0,2,1,0,7,5,15,92926,12,2,1,6,1
24,474,03786,0,0,0,0,10,0,2,0,0,11,1,20,75986,12,2,0,10,0
24,474,03787,0,0,0,17,24,10,8,0,0,37,6,10,145252,43,18,0,41,0
24,475,03788,0,1,30,12,17,3,8,4,0,23,3,37,171000,26,11,4,29,1
24,475,03789,0,1,79,27,25,4,8,2,0,29,10,100,218041,39,12,2,52,1
24,475,03790,0,1,30,38,21,5,13,2,0,33,5,40,180641,38,18,2,59,1
24,475,03791,0,0,0,31,0,6,0,0,0,22,0,0,75606,22,6,0,31,0
24,475,03792,0,2,185,12,95,7,38,24,0,20,86,252,359325,106,45,24,107,2
24,475,03793,0,0,0,29,0,5,0,0,0,22,0,0,118902,22,5,0,29,0
24,475,03794,0,2,91,32,29,29,15,4,0,31,15,105,220855,46,44,4,61,2
24,475,03795,0,0,0,35,0,7,0,0,0,21,0,0,138643,21,7,0,35,0
24,475,03796,0,0,0,67,0,12,0,0,0,21,0,0,97916,21,12,0,67,0
24,475,03797,0,1,64,16,24,46,9,2,0,53,10,100,175339,63,55,2,40,1
24,476,03798,0,1,35,7,14,8,4,2,0,17,2,48,78692,19,12,2,21,1
24,476,03799,0,1,200,63,120,8,40,21,0,34,55,238,403995,89,48,21,183,1
24,476,03800,0,0,0,47,0,3,0,0,0,25,0,0,87577,25,3,0,47,0
24,476,03801,0,1,56,27,31,8,21,5,0,34,11,83,219065,45,29,5,58,1
24,476,03802,0,0,0,19,2,2,2,0,0,24,1,3,74781,25,4,0,21,0
24,476,03803,0,1,841,14,681,10,405,380,0,31,482,899,1533821,513,415,380,695,1
24,476,03804,0,0,0,19,0,2,0,0,0,12,0,0,57415,12,2,0,19,0
24,476,03805,3,1,5,57,7,24,7,4,4,22,3,9,90460,25,31,8,64,4
24,476,03806,0,1,75,19,12,9,11,5,0,57,7,96,314124,64,20,5,31,1
24,476,03807,0,1,150,44,106,14,13,8,0,40,19,154,285550,59,27,8,150,1
24,476,03808,3,0,0,21,0,14,0,0,3,30,0,0,78130,30,14,3,21,3
24,476,03809,0,2,94,32,44,1,19,6,0,32,19,128,178912,51,20,6,76,2
24,476,03810,0,1,75,37,40,5,13,8,0,21,4,89,154896,25,18,8,77,1
24,476,03811,0,1,28,66,33,7,14,3,0,27,16,51,247140,43,21,3,99,1
24,477,03812,0,1,30,25,33,3,13,3,0,16,10,42,162828,26,16,3,58,1
24,477,03813,1,1,90,53,40,6,26,11,1,32,7,143,268062,39,32,12,93,2
24,477,03814,0,4,1417,88,1580,7,413,328,0,38,84,1718,851944,122,420,328,1668,4
24,477,03815,0,0,0,39,0,10,0,0,0,32,0,0,85958,32,10,0,39,0
24,477,03816,0,1,25,16,16,4,7,4,0,16,5,50,79315,21,11,4,32,1
24,477,03817,0,1,30,69,30,5,15,3,0,34,2,48,139729,36,20,3,99,1
24,477,03818,1,0,0,66,0,6,0,0,0,29,0,0,118187,29,6,0,66,1
24,477,03819,0,0,0,59,8,4,2,0,0,39,1,21,196033,40,6,0,67,0
24,477,03820,1,0,0,41,6,2,5,0,0,29,5,3,125127,34,7,0,47,1
24,477,03821,0,1,15,31,26,8,8,2,0,33,3,29,132498,36,16,2,57,1
24,478,03822,1,1,100,136,27,29,30,12,0,66,17,127,384660,83,59,12,163,2
24,478,03823,0,1,16,23,24,3,12,3,0,16,8,32,114219,24,15,3,47,1
24,478,03824,0,1,10,38,19,2,9,3,0,24,2,25,86221,26,11,3,57,1
24,479,03825,0,2,75,42,32,3,15,4,0,25,12,111,132830,37,18,4,74,2
24,479,03826,0,1,10,18,8,5,8,2,0,23,3,28,97189,26,13,2,26,1
24,479,03827,0,1,510,34,320,14,84,43,0,34,70,652,439375,104,98,43,354,1
24,479,03828,0,0,0,27,0,8,0,0,0,25,0,0,79707,25,8,0,27,0
24,479,03829,0,0,0,85,17,11,5,0,0,37,4,12,139916,41,16,0,102,0
24,479,03830,1,0,0,32,0,5,0,0,3,25,0,0,68531,25,5,3,32,1
24,479,03831,0,1,30,9,33,5,8,4,0,30,9,37,194746,39,13,4,42,1
24,479,03832,0,0,0,32,11,24,9,0,0,34,15,30,212973,49,33,0,43,0
24,479,03833,0,1,32,101,7,13,2,1,0,37,1,44,160181,38,15,1,108,1
24,479,03834,2,1,30,45,13,6,6,2,2,29,3,30,135465,32,12,4,58,3
24,479,03835,0,1,80,49,26,4,12,5,0,32,35,95,322492,67,16,5,75,1
24,479,03836,0,0,0,39,9,4,4,0,0,23,4,16,141968,27,8,0,48,0
24,479,03837,0,0,0,8,14,3,5,0,0,42,11,16,228809,53,8,0,22,0
24,479,03838,0,1,30,96,19,13,8,4,0,73,3,48,388349,76,21,4,115,1
24,480,03839,2,0,0,81,0,12,0,0,4,28,0,0,99794,28,12,4,81,2
24,480,03840,0,1,30,21,18,4,8,3,0,25,7,42,140521,32,12,3,39,1
24,480,03841,0,1,55,65,29,5,12,2,0,23,9,73,132900,32,17,2,94,1
24,480,03842,0,1,30,22,12,11,6,3,0,16,3,30,60423,19,17,3,34,1
24,480,03843,0,1,220,144,132,13,27,17,0,38,57,225,241279,95,40,17,276,1
24,480,03844,0,1,30,69,13,4,6,3,0,14,6,43,83054,20,10,3,82,1
24,480,03845,5,0,0,173,4,13,4,0,0,35,5,0,139807,40,17,0,177,5
24,480,03846,0,1,18,17,25,7,8,4,0,50,13,18,239272,63,15,4,42,1
24,480,03847,1,0,0,52,0,11,0,0,2,23,0,0,93431,23,11,2,52,1
24,480,03848,0,0,0,23,16,4,7,0,0,16,9,17,108002,25,11,0,39,0
24,480,03849,0,1,76,45,27,4,10,5,0,31,7,82,175693,38,14,5,72,1
24,481,03850,0,1,30,78,9,8,7,2,0,35,22,30,286618,57,15,2,87,1
24,481,03851,0,0,0,37,10,3,4,0,0,20,2,3,80191,22,7,0,47,0
24,481,03852,0,0,0,48,10,3,9,0,0,43,8,35,200475,51,12,0,58,0
24,481,03853,0,0,0,12,15,7,7,0,0,24,3,8,86323,27,14,0,27,0
24,481,03854,0,2,734,16,511,53,270,210,0,31,57,928,787319,88,323,210,527,2
24,481,03855,0,0,0,32,9,5,2,0,0,19,1,3,100977,20,7,0,41,0
24,481,03856,3,2,60,96,34,11,13,3,0,52,7,92,212236,59,24,3,130,5
24,481,03857,0,1,40,81,19,13,12,3,0,29,10,85,118276,39,25,3,100,1
24,481,03858,0,1,20,62,10,4,10,2,0,33,13,39,230271,46,14,2,72,1
24,481,03859,0,1,40,103,31,8,12,3,0,54,14,47,325667,68,20,3,134,1
24,481,03860,0,1,147,46,15,11,12,5,0,73,26,175,451983,99,23,5,61,1
24,482,03861,0,0,0,28,0,6,0,0,0,19,0,0,88522,19,6,0,28,0
24,482,03862,0,1,20,72,19,2,15,4,0,20,4,50,106526,24,17,4,91,1
24,482,03863,0,1,30,49,21,4,6,2,0,37,11,40,188029,48,10,2,70,1
24,482,03864,0,4,791,104,733,8,456,396,0,57,66,1066,609307,123,464,396,837,4
24,482,03865,0,1,120,160,21,12,27,16,0,54,11,156,287924,65,39,16,181,1
24,482,03866,0,1,160,74,31,6,22,13,0,39,20,183,285679,59,28,13,105,1
24,482,03867,1,0,0,101,15,15,6,0,1,77,28,41,379650,105,21,1,116,1
24,482,03868,0,1,30,45,28,4,8,3,0,28,6,62,147108,34,12,3,73,1
24,483,03869,0,1,140,84,33,9,12,8,0,52,30,155,273168,82,21,8,117,1
24,483,03870,0,0,0,32,2,2,2,0,0,17,3,8,100282,20,4,0,34,0
24,483,03871,0,1,60,46,13,3,9,3,0,23,5,70,145823,28,12,3,59,1
24,483,03872,0,1,30,65,21,5,7,2,0,34,6,40,208626,40,12,2,86,1
24,483,03873,0,1,90,67,24,12,13,7,0,54,3,106,255978,57,25,7,91,1
24,483,03874,0,1,45,48,6,11,10,2,0,26,5,78,128162,31,21,2,54,1
24,483,03875,0,0,0,110,0,20,0,0,0,38,0,0,162800,38,20,0,110,0
24,483,03876,0,1,180,79,125,26,58,38,0,69,61,232,550330,130,84,38,204,1
24,483,03877,0,0,0,52,4,8,4,0,0,26,3,13,132560,29,12,0,56,0
24,483,03878,0,2,40,87,56,9,15,2,0,54,20,96,342145,74,24,2,143,2
24,484,03879,0,0,0,7,0,3,0,0,0,23,0,0,96041,23,3,0,7,0
24,484,03880,0,0,0,27,0,13,0,0,0,42,0,0,129545,42,13,0,27,0
24,484,03881,0,1,50,72,28,11,12,7,0,85,8,68,265653,93,23,7,100,1
24,484,03882,0,1,50,37,23,6,7,3,0,63,10,50,257211,73,13,3,60,1
24,484,03883,0,0,0,41,6,23,3,0,0,69,9,16,277559,78,26,0,47,0
24,484,03884,0,0,0,12,0,17,0,0,0,63,0,0,186920,63,17,0,12,0
24,484,03885,0,2,241,214,103,18,38,23,0,109,37,268,462516,146,56,23,317,2
24,484,03886,3,1,75,39,47,21,23,5,0,66,8,101,216371,74,44,5,86,4
24,484,03887,0,0,0,115,0,15,0,0,0,69,0,0,218467,69,15,0,115,0
24,484,03888,0,0,0,21,6,10,5,0,0,52,19,12,237959,71,15,0,27,0
24,484,03889,2,0,0,8,0,9,0,0,2,17,0,0,42476,17,9,2,8,2
24,485,03890,0,0,0,96,0,8,0,0,0,53,0,0,238116,53,8,0,96,0
24,485,03891,0,0,0,248,16,51,10,0,0,105,10,5,473273,115,61,0,264,0
24,485,03892,0,1,30,5,15,4,7,1,0,64,3,50,306269,67,11,1,20,1
24,485,03893,0,2,260,9,103,10,31,17,0,58,10,298,480845,68,41,17,112,2
24,485,03894,1,0,0,67,0,10,0,0,1,46,0,0,198879,46,10,1,67,1
24,485,03895,0,1,75,84,34,9,15,9,0,99,6,86,249335,105,24,9,118,1
24,485,03896,0,0,0,74,0,8,0,0,0,50,0,0,180345,50,8,0,74,0
24,486,03897,0,1,40,25,111,8,16,4,0,54,6,50,254979,60,24,4,136,1
24,486,03898,1,5,3963,19,1707,17,788,582,1,49,387,4332,2009434,436,805,583,1726,6
24,486,03899,3,0,0,72,25,9,13,0,1,37,4,52,149874,41,22,1,97,3
24,486,03900,5,1,20,157,32,18,7,1,4,86,3,25,261333,89,25,5,189,6
24,486,03901,0,1,116,64,28,6,9,5,0,62,9,142,241336,71,15,5,92,1
24,486,03902,0,0,0,41,3,16,3,0,0,88,2,7,210002,90,19,0,44,0
24,486,03903,0,0,0,32,9,7,3,0,0,83,1,6,155367,84,10,0,41,0
24,486,03904,0,1,10,76,10,12,2,1,0,55,4,14,203584,59,14,1,86,1
24,486,03905,0,1,100,19,16,5,14,4,0,44,15,114,180518,59,19,4,35,1
24,486,03906,0,1,30,30,28,11,20,5,0,57,5,65,265891,62,31,5,58,1
24,486,03907,2,1,45,16,97,11,12,10,1,42,2,61,167579,44,23,11,113,3
24,486,03908,0,0,0,36,0,16,0,0,0,29,0,0,65440,29,16,0,36,0
24,487,03909,0,0,0,54,0,6,0,0,0,26,0,0,63871,26,6,0,54,0
24,487,03910,0,2,130,50,69,11,17,9,0,59,19,164,241053,78,28,9,119,2
24,487,03911,0,1,30,58,24,6,9,3,0,43,3,40,174447,46,15,3,82,1
24,487,03912,0,1,16,33,24,3,11,2,0,25,4,45,110883,29,14,2,57,1
24,488,03913,0,0,0,38,18,5,11,0,0,46,7,15,197038,53,16,0,56,0
24,488,03914,0,0,0,29,4,3,3,0,0,26,9,20,93819,35,6,0,33,0
24,488,03915,0,0,0,43,0,6,0,0,0,18,0,0,100044,18,6,0,43,0
24,488,03916,6,3,290,31,120,9,62,35,4,38,69,359,452517,107,71,39,151,9
24,488,03917,0,0,0,85,0,15,0,0,0,53,0,0,185290,53,15,0,85,0
24,488,03918,0,2,95,46,49,6,26,4,0,31,17,129,315596,48,32,4,95,2
24,488,03919,0,0,0,26,0,5,0,0,0,23,0,0,61268,23,5,0,26,0
24,488,03920,1,0,0,67,1,16,1,0,1,48,1,4,145395,49,17,1,68,1
24,489,03921,0,1,150,22,65,11,18,9,0,55,6,157,228291,61,29,9,87,1
24,490,03922,0,2,630,134,78,28,61,40,0,56,34,690,311238,90,89,40,212,2
24,490,03923,0,0,0,252,12,39,4,0,0,50,25,13,228065,75,43,0,264,0
24,490,03924,0,3,55,199,51,19,27,4,0,53,32,108,249264,85,46,4,250,3
24,490,03925,0,0,0,220,8,24,8,0,0,111,16,18,309877,127,32,0,228,0
24,490,03926,0,1,111,175,16,24,19,8,0,86,4,131,231228,90,43,8,191,1
24,491,03927,0,2,1440,144,925,16,313,296,0,102,47,1499,415140,149,329,296,1069,2
24,491,03928,0,1,71,112,41,10,20,9,0,65,12,100,215872,77,30,9,153,1
24,491,03929,0,4,390,82,59,9,34,16,0,72,58,424,518814,130,43,16,141,4
24,491,03930,0,0,0,155,0,17,0,0,0,86,0,0,258888,86,17,0,155,0
24,491,03931,0,3,55,61,64,6,34,9,0,48,16,104,296964,64,40,9,125,3
24,492,03932,0,2,60,67,55,9,25,18,0,43,6,96,196846,49,34,18,122,2
24,492,03933,0,0,0,69,6,6,6,0,0,55,11,8,209054,66,12,0,75,0
24,492,03934,0,0,0,25,0,4,0,0,0,30,0,0,83723,30,4,0,25,0
24,492,03935,0,0,0,104,4,11,5,0,0,75,8,6,195941,83,16,0,108,0
24,492,03936,0,0,0,63,0,5,0,0,0,49,0,0,184554,49,5,0,63,0
24,492,03937,0,1,2070,0,710,0,370,289,0,0,578,2428,4467797,578,370,289,710,1
24,492,03938,0,2,55,24,49,4,28,14,0,19,12,99,195446,31,32,14,73,2
24,492,03939,0,0,0,42,3,2,4,0,0,32,3,5,145052,35,6,0,45,0
24,492,03940,0,1,26,79,22,7,15,7,0,61,6,55,224127,67,22,7,101,1
24,492,03941,1,0,0,88,0,26,0,0,2,62,0,0,144906,62,26,2,88,1
24,493,03942,3,0,0,69,0,8,0,0,0,41,0,0,129969,41,8,0,69,3
24,493,03943,0,0,0,25,0,11,0,0,0,45,0,0,88416,45,11,0,25,0
24,493,03944,7,1,60,44,57,8,24,5,0,90,22,98,229782,112,32,5,101,8
24,493,03945,0,1,150,162,15,24,21,14,0,95,17,156,268289,112,45,14,177,1
24,493,03946,2,0,0,65,0,12,0,0,2,59,0,0,90566,59,12,2,65,2
25,494,03947,0,1,40,13,62,3,8,2,0,6,4,70,52074,10,11,2,75,1
25,495,03948,0,2,142,27,83,0,20,15,0,12,22,213,191173,34,20,15,110,2
26,496,03949,0,1,231,152,287,26,50,41,0,47,35,233,343709,82,76,41,439,1
27,497,03950,13,2,36,326,45,110,11,5,13,134,5,66,245861,139,121,18,371,15
27,497,03951,13,1,10,273,35,98,25,15,13,110,8,40,195650,118,123,28,308,14
27,497,03952,3,1,50,113,70,35,34,7,3,51,24,166,159654,75,69,10,183,4
27,497,03953,13,1,55,340,36,113,6,2,13,146,29,85,407728,175,119,15,376,14
27,497,03954,10,1,200,257,92,85,31,26,10,96,37,240,367446,133,116,36,349,11
27,497,03955,6,2,80,235,98,74,20,8,6,90,48,185,271852,138,94,14,333,8
27,498,03956,9,2,100,271,42,74,15,5,9,110,35,240,422137,145,89,14,313,11
27,498,03957,9,1,50,287,35,98,14,8,9,114,15,100,323157,129,112,17,322,10
27,498,03958,15,2,60,415,43,139,16,3,15,185,7,235,464913,192,155,18,458,17
27,498,03959,12,3,590,325,253,103,163,143,12,125,21,635,840612,146,266,155,578,15
27,499,03960,7,2,114,222,83,60,18,14,7,82,26,144,312815,108,78,21,305,9
27,499,03961,7,1,30,191,39,57,12,3,7,74,99,95,272242,173,69,10,230,8
27,499,03962,9,2,54,232,39,80,13,3,9,101,45,113,312082,146,93,12,271,11
27,499,03963,4,0,0,130,0,31,0,0,4,52,0,0,163444,52,31,4,130,4
27,499,03964,3,0,0,69,0,21,0,0,3,26,0,0,91799,26,21,3,69,3
27,499,03965,3,2,56,108,75,33,13,4,3,40,63,81,359461,103,46,7,183,5
27,499,03966,5,3,382,148,120,48,25,10,5,68,442,654,676041,510,73,15,268,8
27,499,03967,4,1,30,112,24,34,26,19,4,45,58,70,166521,103,60,23,136,5
27,499,03968,4,1,30,127,23,32,6,2,4,42,10,35,173447,52,38,6,150,5
27,499,03969,7,1,30,191,56,63,8,1,7,73,41,90,287849,114,71,8,247,8
27,499,03970,4,1,30,111,19,29,5,3,4,42,27,35,196863,69,34,7,130,5
27,499,03971,4,1,30,89,42,32,28,22,4,40,28,50,162889,68,60,26,131,5
27,499,03972,11,1,30,285,20,89,6,2,11,106,59,75,414879,165,95,13,305,12
27,499,03973,5,1,30,148,18,44,7,2,5,70,58,80,289592,128,51,7,166,6
27,499,03974,8,1,50,207,47,67,12,8,8,90,35,80,349942,125,79,16,254,9
27,500,03975,2,1,30,55,6,18,3,2,2,28,11,40,156461,39,21,4,61,3
27,500,03976,5,0,0,96,0,42,0,0,5,46,0,0,137047,46,42,5,96,5
27,500,03977,4,1,100,81,53,32,16,2,4,35,19,220,156116,54,48,6,134,5
27,500,03978,1,1,6,75,60,23,13,2,1,36,3,40,175964,39,36,3,135,2
27,500,03979,2,2,50,77,64,20,17,2,2,36,82,102,178419,118,37,4,141,4
27,500,03980,5,0,0,107,0,39,0,0,5,51,0,0,166565,51,39,5,107,5
27,500,03981,6,2,200,137,105,46,27,19,6,60,35,309,320644,95,73,25,242,8
27,500,03982,5,1,30,131,11,48,4,1,5,64,16,80,268298,80,52,6,142,6
27,500,03983,6,1,30,158,30,52,3,1,6,65,24,90,285197,89,55,7,188,7
27,500,03984,6,2,382,149,466,49,44,31,6,63,21,552,286992,84,93,37,615,8
27,500,03985,3,1,30,68,17,23,5,2,3,30,9,40,125350,39,28,5,85,4
27,500,03986,4,1,30,107,8,30,4,3,4,43,3,40,176303,46,34,7,115,5
27,500,03987,4,1,30,97,20,28,4,1,4,36,1,55,152334,37,32,5,117,5
27,501,03988,3,1,30,96,29,26,3,2,3,44,3,35,172300,47,29,5,125,4
27,501,03989,2,1,30,114,46,42,10,2,2,59,6,95,255354,65,52,4,160,3
27,501,03990,4,1,30,95,21,35,5,2,4,48,4,45,189375,52,40,6,116,5
27,501,03991,6,2,817,165,371,56,219,200,6,77,223,877,733761,300,275,206,536,8
27,501,03992,4,1,100,112,30,38,15,2,4,49,5,200,174568,54,53,6,142,5
27,501,03993,5,0,0,101,2,41,1,0,5,47,1,6,138715,48,42,5,103,5
27,501,03994,5,0,0,138,0,46,0,0,5,56,0,0,149321,56,46,5,138,5
27,502,03995,5,0,0,142,0,39,0,0,5,58,0,0,189051,58,39,5,142,5
27,502,03996,5,1,30,112,16,34,4,1,5,42,3,45,175146,45,38,6,128,6
27,502,03997,5,1,30,160,9,66,3,3,5,73,18,30,213791,91,69,8,169,6
27,502,03998,4,0,0,107,0,40,0,0,4,52,0,0,156339,52,40,4,107,4
27,502,03999,5,1,200,127,72,39,23,2,5,50,28,260,255188,78,62,7,199,6
27,502,04000,4,1,30,101,20,30,7,3,4,47,5,45,207545,52,37,7,121,5
27,503,04001,6,1,50,204,42,61,13,9,6,96,2,80,184661,98,74,15,246,7
27,503,04002,6,1,30,223,19,74,5,3,6,97,11,35,118785,108,79,9,242,7
27,503,04003,3,1,30,87,14,26,4,3,3,34,11,30,160893,45,30,6,101,4
27,503,04004,3,1,70,98,78,29,15,12,3,46,14,107,279296,60,44,15,176,4
27,503,04005,4,1,30,107,19,38,2,2,4,56,2,30,196161,58,40,6,126,5
27,503,04006,5,1,50,115,52,43,13,2,5,50,7,135,182286,57,56,7,167,6
27,503,04007,4,2,38,102,41,34,15,5,4,47,35,107,224688,82,49,9,143,6
27,503,04008,4,0,0,79,0,35,0,0,4,39,0,0,104728,39,35,4,79,4
27,503,04009,4,3,755,117,510,37,110,63,4,51,204,1072,788089,255,147,67,627,7
27,503,04010,3,0,0,82,0,23,0,0,3,35,0,0,113105,35,23,3,82,3
27,503,04011,3,1,50,89,42,32,11,6,3,46,3,80,175019,49,43,9,131,4
27,503,04012,5,0,0,124,0,44,0,0,5,52,0,0,129677,52,44,5,124,5
27,503,04013,2,1,30,53,20,17,8,3,2,26,5,65,96871,31,25,5,73,3
27,503,04014,3,1,30,96,19,27,4,2,3,35,10,50,132915,45,31,5,115,4
27,504,04015,2,0,0,58,0,16,0,0,2,28,0,0,76111,28,16,2,58,2
27,504,04016,3,0,0,93,0,27,0,0,3,40,0,0,90448,40,27,3,93,3
27,504,04017,3,1,50,93,24,29,23,20,3,46,7,67,145775,53,52,23,117,4
27,504,04018,3,1,6,149,17,40,6,1,3,58,2,27,129308,60,46,4,166,4
27,504,04019,3,6,367,104,301,26,59,34,3,40,50,529,357298,90,85,37,405,9
27,504,04020,4,1,30,120,40,37,10,3,4,50,9,56,159713,59,47,7,160,5
27,504,04021,4,1,100,111,103,31,23,15,4,44,57,150,223866,101,54,19,214,5
27,504,04022,4,0,0,108,0,27,0,0,4,41,0,0,116933,41,27,4,108,4
27,505,04023,3,2,35,117,29,31,7,2,3,49,17,85,147769,66,38,5,146,5
27,505,04024,2,1,30,96,19,22,6,3,2,44,8,45,163657,52,28,5,115,3
27,505,04025,2,2,35,78,33,27,9,2,2,36,9,75,122133,45,36,4,111,4
27,505,04026,3,3,50,103,201,25,39,9,3,41,13,178,229157,54,64,12,304,6
27,505,04027,4,0,0,102,20,30,10,0,4,42,2,44,142913,44,40,4,122,4
27,505,04028,5,1,50,162,47,49,12,7,5,64,13,80,158568,77,61,12,209,6
27,505,04029,3,1,10,105,38,26,8,2,3,38,7,40,139723,45,34,5,143,4
27,505,04030,1,2,82,59,64,14,18,4,1,26,9,200,238870,35,32,5,123,3
27,505,04031,2,1,10,48,8,18,3,1,2,23,13,20,302054,36,21,3,56,3
27,505,04032,0,17,4175,0,2671,0,282,209,0,0,685,4500,2405665,685,282,209,2671,17
27,505,04033,4,0,0,102,24,27,10,0,4,38,4,65,241902,42,37,4,126,4
27,505,04034,4,1,30,108,12,29,6,3,4,39,6,60,153971,45,35,7,120,5
27,505,04035,5,0,0,169,0,39,0,0,5,56,0,0,123821,56,39,5,169,5
27,505,04036,3,0,0,94,0,30,0,0,3,39,0,0,81351,39,30,3,94,3
27,506,04037,5,1,100,167,48,42,18,2,5,66,15,200,226021,81,60,7,215,6
27,506,04038,5,0,0,133,9,38,3,0,5,53,1,30,150546,54,41,5,142,5
27,506,04039,4,2,482,102,359,29,61,41,4,45,81,615,279941,126,90,45,461,6
27,506,04040,5,1,50,125,33,38,13,7,5,55,11,100,136871,66,51,12,158,6
27,506,04041,6,1,30,167,19,47,6,3,6,58,1,55,128503,59,53,9,186,7
27,506,04042,4,1,50,107,39,28,7,4,4,45,14,75,154509,59,35,8,146,5
27,506,04043,5,0,0,154,0,43,0,0,5,55,0,0,123573,55,43,5,154,5
27,507,04044,4,1,50,129,16,34,8,6,4,53,2,55,176254,55,42,10,145,5
27,507,04045,5,0,0,142,0,44,0,0,5,50,0,0,124865,50,44,5,142,5
27,507,04046,9,2,416,228,268,71,70,25,9,92,151,620,421650,243,141,34,496,11
27,507,04047,4,0,0,107,26,33,8,0,4,42,3,58,130657,45,41,4,133,4
27,507,04048,2,1,30,127,17,42,5,2,2,49,2,55,90657,51,47,4,144,3
27,507,04049,5,0,0,147,0,45,0,0,5,56,0,0,115564,56,45,5,147,5
27,507,04050,7,0,0,213,0,75,0,0,7,92,0,0,148153,92,75,7,213,7
27,507,04051,5,1,30,144,25,47,6,1,5,61,4,75,114518,65,53,6,169,6
27,508,04052,3,0,0,72,31,19,8,0,3,29,3,60,83593,32,27,3,103,3
27,508,04053,4,0,0,131,0,31,0,0,4,58,0,0,97009,58,31,4,131,4
27,508,04054,2,1,50,129,11,35,7,7,2,60,2,50,85957,62,42,9,140,3
27,508,04055,2,0,0,94,0,31,0,0,2,43,0,0,42577,43,31,2,94,2
27,508,04056,6,0,0,188,0,56,0,0,6,80,0,0,82100,80,56,6,188,6
27,508,04057,3,6,282,114,138,24,49,31,3,46,13,438,145749,59,73,34,252,9
27,508,04058,6,0,0,199,0,53,0,0,6,87,0,0,179046,87,53,6,199,6
27,508,04059,3,0,0,84,0,30,0,0,3,29,0,0,45753,29,30,3,84,3
27,508,04060,4,0,0,130,0,41,0,0,4,64,0,0,81522,64,41,4,130,4
27,508,04061,3,0,0,104,0,37,0,0,3,46,0,0,36030,46,37,3,104,3
27,508,04062,3,1,50,141,17,38,6,2,3,59,5,75,116911,64,44,5,158,4
27,508,04063,2,1,30,131,32,37,7,3,2,58,5,49,74621,63,44,5,163,3
27,509,04064,3,1,50,121,25,30,8,7,3,52,6,52,171472,58,38,10,146,4
27,509,04065,8,0,0,210,0,77,0,0,8,95,0,0,169435,95,77,8,210,8
27,509,04066,5,0,0,156,0,43,0,0,5,56,0,0,132961,56,43,5,156,5
27,509,04067,5,3,329,169,21,43,3,3,5,59,20,329,166087,79,46,8,190,8
27,509,04068,6,0,0,122,0,42,0,0,6,49,0,0,107893,49,42,6,122,6
27,509,04069,5,0,0,114,0,38,0,0,5,47,0,0,110440,47,38,5,114,5
27,509,04070,4,2,80,116,28,38,8,4,4,47,8,118,158709,55,46,8,144,6
27,509,04071,1,12,434,47,348,9,76,41,1,21,103,765,481708,124,85,42,395,13
27,509,04072,3,1,50,93,53,29,11,7,3,36,5,80,114571,41,40,10,146,4
27,509,04073,2,0,0,56,0,18,0,0,2,23,0,0,50781,23,18,2,56,2
27,509,04074,1,1,30,41,36,13,17,3,1,13,18,102,134527,31,30,4,77,2
27,509,04075,4,1,30,119,25,30,8,3,4,42,18,55,125269,60,38,7,144,5
27,509,04076,2,0,0,62,0,18,0,0,2,29,0,0,61820,29,18,2,62,2
27,509,04077,3,1,30,92,43,24,10,3,3,37,6,70,138408,43,34,6,135,4
27,509,04078,2,1,30,64,9,16,2,1,2,26,2,30,79629,28,18,3,73,3
27,510,04079,2,1,30,79,15,23,3,2,2,31,7,30,120148,38,26,4,94,3
27,510,04080,4,0,0,106,0,29,0,0,4,39,0,0,88011,39,29,4,106,4
27,510,04081,4,0,0,129,0,37,0,0,4,55,0,0,102966,55,37,4,129,4
27,510,04082,5,4,822,153,363,39,162,122,5,67,81,1053,382876,148,201,127,516,9
27,510,04083,5,2,70,128,35,36,21,3,5,50,6,175,191031,56,57,8,163,7
27,510,04084,2,1,30,51,41,14,13,5,2,20,17,75,154086,37,27,7,92,3
27,510,04085,6,1,50,165,27,51,10,7,6,80,42,55,341172,122,61,13,192,7
27,510,04086,5,2,30,139,30,46,7,1,5,65,60,69,259288,125,53,6,169,7
27,510,04087,5,0,0,122,0,42,0,0,5,51,0,0,190249,51,42,5,122,5
27,510,04088,5,0,0,112,0,37,0,0,5,48,0,0,161830,48,37,5,112,5
27,510,04089,3,1,30,113,33,31,8,4,3,47,2,60,138587,49,39,7,146,4
27,510,04090,6,1,50,182,47,48,17,13,6,69,8,97,156741,77,65,19,229,7
27,510,04091,5,0,0,135,0,38,0,0,5,56,0,0,112094,56,38,5,135,5
27,510,04092,3,0,0,80,0,22,0,0,3,29,0,0,78713,29,22,3,80,3
27,510,04093,3,0,0,110,0,32,0,0,3,43,0,0,80131,43,32,3,110,3
27,510,04094,2,2,40,98,62,28,20,7,2,46,8,113,213607,54,48,9,160,4
27,511,04095,4,0,0,114,0,38,0,0,4,50,0,0,99940,50,38,4,114,4
27,511,04096,8,1,20,231,25,62,4,2,8,102,4,22,247786,106,66,10,256,9
27,511,04097,3,0,0,77,0,24,0,0,3,32,0,0,109715,32,24,3,77,3
27,511,04098,6,1,50,178,56,50,13,8,6,67,6,115,259986,73,63,14,234,7
27,511,04099,2,0,0,54,0,15,0,0,2,22,0,0,109314,22,15,2,54,2
27,511,04100,6,5,513,121,418,49,162,80,6,48,264,1083,719188,312,211,86,539,11
27,511,04101,3,1,30,78,40,22,14,4,3,28,3,95,115696,31,36,7,118,4
27,511,04102,3,1,30,72,34,25,11,4,3,34,4,55,138313,38,36,7,106,4
27,511,04103,1,1,60,34,15,8,5,1,1,16,5,120,99019,21,13,2,49,2
27,511,04104,3,1,30,54,63,22,12,4,3,23,3,90,96775,26,34,7,117,4
27,511,04105,2,2,40,72,52,21,12,6,2,32,3,100,170157,35,33,8,124,4
27,511,04106,3,0,0,83,0,26,0,0,3,42,0,0,182868,42,26,3,83,3
27,511,04107,5,2,30,150,37,44,9,4,5,60,6,60,241885,66,53,9,187,7
27,511,04108,5,1,30,154,24,44,5,3,5,60,3,35,248824,63,49,8,178,6
27,511,04109,6,1,100,153,96,54,20,13,6,68,24,105,293843,92,74,19,249,7
27,511,04110,3,1,50,107,35,32,12,7,3,50,33,115,227819,83,44,10,142,4
27,512,04111,5,0,0,128,0,50,0,0,5,66,0,0,204122,66,50,5,128,5
27,512,04112,4,1,100,119,64,39,95,89,4,54,27,145,269458,81,134,93,183,5
27,512,04113,5,0,0,129,0,37,0,0,5,55,0,0,181148,55,37,5,129,5
27,512,04114,6,1,30,138,19,42,5,3,6,65,2,40,231538,67,47,9,157,7
27,512,04115,6,1,50,163,18,48,17,12,6,64,17,80,290890,81,65,18,181,7
27,513,04116,2,1,50,75,50,13,12,5,2,36,21,90,169173,57,25,7,125,3
27,513,04117,6,1,30,162,66,49,14,3,6,75,11,125,282756,86,63,9,228,7
27,513,04118,5,2,477,170,269,45,55,32,5,82,100,542,537810,182,100,37,439,7
27,513,04119,2,1,30,67,54,17,14,3,2,32,31,84,116817,63,31,5,121,3
27,513,04120,4,1,30,88,21,27,5,3,4,39,10,60,139046,49,32,7,109,5
27,513,04121,0,1,7,21,22,1,7,1,0,11,2,39,89582,13,8,1,43,1
27,513,04122,5,1,50,92,39,31,10,2,5,41,5,105,202865,46,41,7,131,6
27,513,04123,3,0,0,70,0,23,0,0,3,30,0,0,115382,30,23,3,70,3
27,513,04124,4,2,35,96,40,30,14,6,4,46,40,75,182652,86,44,10,136,6
27,514,04125,9,1,68,217,22,66,4,4,9,89,1,68,311286,90,70,13,239,10
27,514,04126,6,0,0,141,0,58,0,0,6,61,0,0,163120,61,58,6,141,6
27,514,04127,7,2,547,175,288,54,102,76,7,66,136,697,519018,202,156,83,463,9
27,514,04128,5,0,0,129,0,43,0,0,5,52,0,0,153772,52,43,5,129,5
27,514,04129,6,1,75,156,43,44,11,2,6,66,11,150,255709,77,55,8,199,7
27,514,04130,6,0,0,161,0,42,0,0,6,59,0,0,211108,59,42,6,161,6
27,514,04131,4,1,60,116,43,29,10,2,4,42,9,125,177589,51,39,6,159,5
27,514,04132,4,0,0,114,0,34,0,0,4,47,0,0,167407,47,34,4,114,4
27,515,04133,12,1,30,304,46,97,13,8,12,110,8,95,340915,118,110,20,350,13
27,515,04134,4,0,0,128,0,35,0,0,4,48,0,0,113022,48,35,4,128,4
27,515,04135,7,1,50,209,25,59,14,11,7,94,53,75,359950,147,73,18,234,8
27,515,04136,6,0,0,132,0,46,0,0,6,52,0,0,161012,52,46,6,132,6
27,515,04137,5,5,1066,128,358,42,69,18,5,67,229,1233,1590340,296,111,23,486,10
27,515,04138,3,1,30,77,33,27,9,5,3,37,3,65,118328,40,36,8,110,4
27,515,04139,6,2,100,158,121,42,41,2,6,69,13,349,311371,82,83,8,279,8
27,515,04140,4,2,112,122,70,33,19,11,4,57,15,157,358155,72,52,15,192,6
27,515,04141,9,1,30,224,41,71,8,3,9,88,21,60,347905,109,79,12,265,10
27,516,04142,6,0,0,209,2,62,2,0,6,74,2,55,175816,76,64,6,211,6
27,516,04143,8,0,0,241,0,67,0,0,8,88,0,0,208362,88,67,8,241,8
27,516,04144,7,0,0,188,0,57,0,0,7,73,0,0,144522,73,57,7,188,7
27,516,04145,12,1,30,312,91,92,21,3,12,119,27,170,374409,146,113,15,403,13
27,516,04146,12,2,252,318,154,98,20,1,12,129,24,446,955594,153,118,13,472,14
27,516,04147,5,2,80,108,81,36,18,9,5,44,22,160,288848,66,54,14,189,7
27,516,04148,5,1,50,159,45,42,15,7,5,61,9,132,235849,70,57,12,204,6
27,516,04149,13,0,0,320,0,98,0,0,13,137,0,0,315709,137,98,13,320,13
27,516,04150,7,0,0,189,0,58,0,0,7,65,0,0,119838,65,58,7,189,7
27,516,04151,5,1,30,205,30,67,10,4,5,83,5,65,168423,88,77,9,235,6
27,516,04152,3,8,1108,123,1139,26,176,120,3,55,648,1506,1755491,703,202,123,1262,11
27,516,04153,8,3,100,217,101,64,35,29,8,88,11,160,253513,99,99,37,318,11
27,516,04154,7,1,50,195,11,54,6,2,7,81,33,65,346390,114,60,9,206,8
27,516,04155,10,4,105,283,57,81,13,4,10,127,19,171,493251,146,94,14,340,14
27,516,04156,5,1,30,128,12,41,5,3,5,56,18,50,271146,74,46,8,140,6
27,517,04157,4,0,0,121,0,33,0,0,4,59,0,0,154818,59,33,4,121,4
27,517,04158,8,1,100,247,71,61,22,2,8,107,21,242,402095,128,83,10,318,9
27,517,04159,3,1,30,83,18,22,9,3,3,34,7,40,137625,41,31,6,101,4
27,517,04160,3,1,10,117,23,32,8,4,3,49,8,35,140187,57,40,7,140,4
27,517,04161,5,0,0,113,0,40,0,0,5,45,0,0,83453,45,40,5,113,5
27,517,04162,3,1,30,121,46,28,11,4,3,55,11,98,178362,66,39,7,167,4
27,517,04163,9,3,70,275,117,90,37,4,9,129,32,377,550166,161,127,13,392,12
27,517,04164,2,1,30,59,84,19,26,4,2,31,197,163,1343402,228,45,6,143,3
27,517,04165,0,7,850,0,1390,0,314,165,0,0,534,1150,3787036,534,314,165,1390,7
27,517,04166,6,2,130,183,164,49,36,5,6,78,11,236,1141381,89,85,11,347,8
27,517,04167,5,3,160,207,112,62,24,15,5,98,18,185,314051,116,86,20,319,8
27,517,04168,2,2,240,86,226,24,51,22,2,70,262,520,1565417,332,75,24,312,4
27,517,04169,0,2,302,0,54,0,56,34,0,0,72,440,506098,72,56,34,54,2
27,517,04170,1,2,77,75,118,22,24,6,1,46,66,161,565282,112,46,7,193,3
27,517,04171,7,1,30,155,16,52,6,2,7,58,2,55,190651,60,58,9,171,8
27,518,99999,0,17,2176,0,1874,0,586,131,0,0,792,8831,9356962,792,586,131,1874,17
27,519,99999,0,19,9645,0,3653,0,2068,1892,0,0,435,10943,3085411,435,2068,1892,3653,19
27,520,04172,1,1,30,27,35,8,6,2,1,12,11,60,160249,23,14,3,62,2
27,520,04173,5,3,64.3095235824585,134,72,36,19.7380952835083,5.714285731315613,5,55,16,202.1666679382324,750236,71,55.738094,10.714286,206,8
27,520,04174,4,3,77,145,51,46,15,10,4,68,14,92,212030,82,61,14,196,7
27,520,04175,3,1,20,82,41,31,7,2,3,34,7,87,207464,41,38,5,123,4
27,520,04176,3,1,50,105,10,29,10,5,3,48,1,100,195442,49,39,8,115,4
27,520,04177,4,1,242,120,48,38,46,38,4,58,75,288,236008,133,84,42,168,5
27,520,04178,0,2,30,44,31,14,8,2,0,20,6,60,74137,26,22,2,75,2
27,520,04179,1,1,30,57,65,18,19,1,1,31,15,165,167110,46,37,2,122,2
27,520,04180,1,0,0,41,6,8,2,0,1,20,2,6,62380,22,10,1,47,1
27,520,04181,3,1,6,110,33,36,5,2,3,45,9,22,159613,54,41,5,143,4
27,520,04182,1,0,0,26,0,8,0,0,1,13,0,0,40580,13,8,1,26,1
27,520,04183,0,1,30,26,16,7,7,3,0,9,9,45,82976,18,14,3,42,1
27,520,04184,1,1,6,39,28,14,9,2,1,18,3,33,59881,21,23,3,67,2
27,520,04185,4,1,30,129,4,46,1,1,4,57,4,30,180191,61,47,5,133,5
27,520,04186,0,0,0,28,18,9,2,0,0,14,12,30,45464,26,11,0,46,0
27,521,04187,13,1,30,328,4,115,23,23,13,167,15,30,399302,182,138,36,332,14
27,521,04188,6,1,25,211,52,78,23,6,6,109,3,207,235948,112,101,12,263,7
27,521,04189,11,1,30,232,30,88,7,2,11,113,11,47,385414,124,95,13,262,12
27,521,04190,11,3,90,268,128,97,37,10,11,136,63,310,450053,199,134,21,396,14
27,521,04191,6,3,93,162,120,69,25,4,6,88,56,231,377440,144,94,10,282,9
27,521,04192,3,0,0,115,33,50,7,0,3,67,5,57,170904,72,57,3,148,3
27,521,04193,11,4,865,235,226,93,75,13,11,171,374,1209,2435581,545,168,24,461,15
27,521,04194,0,9,1551,0,1045,0,161,21,0,1,345,2802,3304888,346,161,21,1045,9
27,521,04195,11,2,80,224,25,91,8,4,11,125,26,170,380496,151,99,15,249,13
27,521,04196,6,2,60,156,202,54,26,4,6,72,38,173,235659,110,80,10,358,8
27,521,04197,0,0,0,59,0,25,0,0,0,33,0,0,54326,33,25,0,59,0
27,521,04198,4,10,100,120,90,45,23,20,4,58,10,144,186091,68,68,24,210,14
27,521,04199,12,1,30,259,50,94,9,3,12,140,76,75,429600,216,103,15,309,13
27,521,04200,9,1,50,199,47,68,12,8,9,103,32,80,383183,135,80,17,246,10
27,522,04201,9,1,30,304,18,105,8,1,9,145,9,90,291950,154,113,10,322,10
27,522,04202,12,2,202,290,245,102,146,47,12,145,25,665,487939,170,248,59,535,14
27,522,04203,6,1,322,145,27,48,7,3,6,72,39,382,302452,111,55,9,172,7
27,522,04204,8,3,280,177,31,67,9,3,8,105,34,330,320485,139,76,11,208,11
27,522,04205,6,1,30,137,30,49,5,2,6,80,21,90,287500,101,54,8,167,7
27,522,04206,9,0,0,211,0,75,0,0,9,120,0,0,357829,120,75,9,211,9
27,522,04207,6,0,0,158,0,51,0,0,6,83,0,0,245714,83,51,6,158,6
27,522,04208,6,1,50,142,26,52,6,2,6,70,12,100,258109,82,58,8,168,7
27,522,04209,10,91,2277,215,867,88,547,520,10,109,245,2518,684044,354,635,530,1082,101
27,522,04210,7,1,30,182,119,62,13,2,7,96,41,245,322823,137,75,9,301,8
27,522,04211,9,0,0,209,0,75,0,0,9,103,0,0,274167,103,75,9,209,9
27,522,04212,7,1,30,158,30,52,6,2,7,82,13,60,315975,95,58,9,188,8
27,522,04213,6,1,50,146,58,49,11,1,6,70,3,100,235792,73,60,7,204,7
27,522,04214,3,1,30,85,21,29,9,4,3,45,12,65,158380,57,38,7,106,4
27,523,04215,4,1,30,134,32,39,7,1,4,65,7,85,243607,72,46,5,166,5
27,523,04216,5,0,0,99,0,36,0,0,5,42,0,0,125081,42,36,5,99,5
27,523,04217,3,0,0,82,0,27,0,0,3,39,0,0,128583,39,27,3,82,3
27,523,04218,6,1,60,156,30,52,9,7,6,80,9,60,338610,89,61,13,186,7
27,523,04219,5,1,30,110,32,41,10,4,5,55,2,95,255174,57,51,9,142,6
27,523,04220,2,0,0,49,0,17,0,0,2,24,0,0,87685,24,17,2,49,2
27,523,04221,8,2,458,186,224,68,51,47,8,92,110,493,481195,202,119,55,410,10
27,523,04222,8,1,50,164,49,66,17,9,8,76,24,85,243832,100,83,17,213,9
27,523,04223,2,1,30,52,21,16,9,3,2,25,7,82,122110,32,25,5,73,3
27,523,04224,5,1,100,124,34,58,19,13,5,71,34,145,287208,105,77,18,158,6
27,523,04225,5,10,590,109,225,37,176,168,5,52,72,630,271957,124,213,173,334,15
27,524,04226,10,2,126,197,290,73,125,74,10,98,61,436,683666,159,198,84,487,12
27,524,04227,6,0,0,119,0,50,0,0,6,58,0,0,142187,58,50,6,119,6
27,524,04228,5,1,40,115,25,41,34,8,5,57,19,150,236168,76,75,13,140,6
27,524,04229,3,0,0,63,0,22,0,0,3,27,0,0,87201,27,22,3,63,3
27,524,04230,4,0,0,105,0,34,0,0,4,55,0,0,177956,55,34,4,105,4
27,524,04231,2,0,0,46,0,16,0,0,2,23,0,0,83528,23,16,2,46,2
27,524,04232,8,1,30,177,29,62,9,4,8,85,18,65,309571,103,71,12,206,9
27,524,04233,8,1,50,173,31,60,12,2,8,80,43,110,325193,123,72,10,204,9
27,524,04234,3,0,0,66,0,23,0,0,3,31,0,0,97598,31,23,3,66,3
27,524,04235,5,1,100,120,14,48,5,2,5,68,64,110,311066,132,53,7,134,6
27,525,04236,4,1,50,85,24,31,9,7,4,38,2,55,140148,40,40,11,109,5
27,525,04237,6,1,30,110,33,45,6,3,6,48,3,37,136729,51,51,9,143,7
27,525,04238,3,0,0,82,0,27,0,0,3,43,0,0,92150,43,27,3,82,3
27,525,04239,6,1,30,136,19,52,7,4,6,70,1,55,217687,71,59,10,155,7
27,525,04240,11,2,342,226,170,85,95,48,11,114,46,578,405736,160,180,59,396,13
27,525,04241,7,1,38,167,45,67,11,1,7,82,11,129,278872,93,78,8,212,8
27,525,04242,5,0,0,99,0,38,0,0,5,50,0,0,116712,50,38,5,99,5
27,525,04243,7,2,150,168,55,63,27,21,7,87,19,185,269519,106,90,28,223,9
27,526,04244,5,1,50,137,42,53,15,8,5,75,26,86,254489,101,68,13,179,6
27,526,04245,8,2,256,205,139,73,24,6,8,117,20,466,324027,137,97,14,344,10
27,526,04246,8,1,30,178,53,59,8,4,8,85,30,92,372711,115,67,12,231,9
27,526,04247,5,20,883,106,509,43,144,36,5,49,230,2043,1057352,279,187,41,615,25
27,526,04248,8,0,0,175,0,62,0,0,8,93,0,0,276920,93,62,8,175,8
27,526,04249,9,1,100,208,46,77,19,14,9,117,77,135,442368,194,96,23,254,10
27,526,04250,11,2,80,282,56,97,14,8,11,157,16,120,485645,173,111,19,338,13
27,526,04251,6,1,30,155,35,49,8,3,6,83,18,65,322845,101,57,9,190,7
27,526,04252,7,1,30,152,26,60,5,4,7,73,8,60,205932,81,65,11,178,8
27,526,04253,7,0,0,161,0,60,0,0,7,96,0,0,260897,96,60,7,161,7
27,526,04254,7,1,30,185,54,62,11,3,7,84,13,114,314563,97,73,10,239,8
27,527,04255,0,3,84,50,87,14,27,9,0,23,15,362,72815,38,41,9,137,3
27,527,04256,3,1,30,119,27,44,5,3,3,67,28,50,200182,95,49,6,146,4
27,527,04257,3,0,0,94,27,41,5,0,3,53,14,34,137418,67,46,3,121,3
27,527,04258,6,1,50,152,9,55,10,2,6,82,24,100,342667,106,65,8,161,7
27,527,04259,6,0,0,154,11,58,3,0,6,80,16,11,225634,96,61,6,165,6
27,527,04260,10,0,0,231,0,88,0,0,10,111,0,0,275241,111,88,10,231,10
27,527,04261,5,2,40,143,44,56,12,2,5,78,31,95,257500,109,68,7,187,7
27,527,04262,7,2,287,192,132,71,26,10,7,98,80,413,502017,178,97,17,324,9
27,527,04263,4,0,0,102,48,35,9,0,4,45,7,0,106346,52,44,4,150,4
27,527,04264,12,1,30,287,19,107,7,1,12,132,5,60,299420,137,114,13,306,13
27,527,04265,12,4,310,300,223,119,60,38,12,166,125,409,584085,291,179,50,523,16
27,528,04266,3,0,0,104,0,37,0,0,3,45,0,0,62105,45,37,3,104,3
27,528,04267,6,1,50,202,95,53,14,1,6,79,16,145,178303,95,67,7,297,7
27,528,04268,4,1,30,226,13,58,4,2,4,85,12,50,181531,97,62,6,239,5
27,528,04269,5,1,50,268,20,61,6,1,5,98,15,86,279078,113,67,6,288,6
27,528,04270,6,0,0,153,0,50,0,0,6,64,0,0,123155,64,50,6,153,6
27,528,04271,5,2,282,237,314,51,43,33,5,80,32,572,319334,112,94,38,551,7
27,528,04272,7,1,30,271,34,68,6,2,7,100,3,45,198306,103,74,9,305,8
27,528,04273,4,1,30,145,43,48,9,2,4,58,6,105,106986,64,57,6,188,5
27,528,04274,4,1,30,207,29,51,7,3,4,79,2,42,165831,81,58,7,236,5
27,529,04275,7,0,0,180,0,51,0,0,7,69,0,0,120905,69,51,7,180,7
27,529,04276,1,0,0,62,0,13,0,0,1,24,0,0,43845,24,13,1,62,1
27,529,04277,4,1,100,167,71,47,17,12,4,67,18,135,135279,85,64,16,238,5
27,529,04278,4,1,30,146,17,39,7,3,4,58,8,60,111807,66,46,7,163,5
27,529,04279,2,1,30,101,23,29,6,3,2,38,5,42,85801,43,35,5,124,3
27,529,04280,5,1,30,172,14,45,4,3,5,68,2,30,155624,70,49,8,186,6
27,529,04281,4,1,100,133,59,31,31,9,4,54,13,235,147458,67,62,13,192,5
27,529,04282,2,0,0,80,0,33,0,0,2,36,0,0,48873,36,33,2,80,2
27,530,04283,7,1,30,212,7,73,7,1,7,88,4,60,185661,92,80,8,219,8
27,530,04284,8,1,30,215,45,71,13,4,8,96,4,65,259417,100,84,12,260,9
27,530,04285,11,4,193,265,339,92,52,33,11,144,120,298,807751,264,144,44,604,15
27,530,04286,10,1,10,228,63,83,11,2,10,126,38,75,391015,164,94,12,291,11
27,530,04287,10,6,1250,254,529,77,113,59,10,119,334,1480,1037713,453,190,69,783,16
27,530,04288,1,0,0,50,0,15,0,0,1,19,0,0,35772,19,15,1,50,1
27,530,04289,8,0,0,216,0,76,0,0,8,96,0,0,199713,96,76,8,216,8
27,530,04290,5,2,60,161,47,45,11,6,5,76,15,95,275372,91,56,11,208,7
27,530,04291,6,0,0,160,0,47,0,0,6,65,0,0,150333,65,47,6,160,6
27,530,04292,4,1,30,116,15,30,5,4,4,46,2,30,120241,48,35,8,131,5
27,530,04293,8,1,100,190,94,58,20,14,8,78,23,125,225734,101,78,22,284,9
27,530,04294,7,0,0,181,0,56,0,0,7,71,0,0,187220,71,56,7,181,7
27,531,04295,8,0,0,236,0,75,0,0,8,102,0,0,162911,102,75,8,236,8
27,531,04296,11,2,80,290,117,96,31,10,11,163,54,185,456002,217,127,21,407,13
27,531,04297,3,0,0,84,0,25,0,0,3,58,0,0,164909,58,25,3,84,3
27,531,04298,6,0,0,138,0,48,0,0,6,60,0,0,143019,60,48,6,138,6
27,531,04299,2,1,30,91,36,27,10,4,2,48,53,105,170214,101,37,6,127,3
27,531,04300,4,0,0,120,0,42,0,0,4,66,0,0,138455,66,42,4,120,4
27,531,04301,8,1,30,194,33,58,7,3,8,86,34,60,251401,120,65,11,227,9
27,531,04302,9,3,413,232,690,71,50,26,9,119,275,582,854581,394,121,35,922,12
27,531,04303,4,0,0,115,0,33,0,0,4,70,0,0,152327,70,33,4,115,4
27,531,04304,10,0,0,249,0,85,0,0,10,120,0,0,328324,120,85,10,249,10
28,532,04305,0,0,0,23,0,3,0,0,0,14,0,0,39631,14,3,0,23,0
28,532,04306,0,1,250,63,130,2,42,25,0,31,26,426,198289,57,44,25,193,1
28,532,04307,0,0,0,102,0,2,0,0,0,48,0,0,47883,48,2,0,102,0
28,532,04308,0,0,0,57,0,4,0,0,0,23,0,0,38318,23,4,0,57,0
28,532,04309,0,0,0,15,0,1,0,0,0,12,0,0,34632,12,1,0,15,0
28,532,04310,0,0,0,11,0,2,0,0,0,13,0,0,30293,13,2,0,11,0
28,532,04311,0,0,0,20,0,4,0,0,0,20,0,0,47506,20,4,0,20,0
28,532,04312,0,0,0,34,0,7,0,0,0,26,0,0,49239,26,7,0,34,0
28,532,04313,0,0,0,15,0,2,0,0,0,31,0,0,30676,31,2,0,15,0
28,532,04314,0,0,0,18,0,2,0,0,0,20,0,0,35456,20,2,0,18,0
28,532,04315,0,0,0,18,0,6,0,0,0,8,0,0,31130,8,6,0,18,0
28,532,04316,0,0,0,21,0,2,0,0,0,28,0,0,50938,28,2,0,21,0
28,532,04317,0,0,0,26,0,3,0,0,0,31,0,0,49284,31,3,0,26,0
28,532,04318,0,1,30,16,20,2,12,10,0,18,18,53,110042,36,14,10,36,1
28,532,04319,0,1,50,13,15,2,4,4,0,20,6,50,58418,26,6,4,28,1
28,532,04320,0,1,30,8,10,0,4,3,0,8,3,40,31453,11,4,3,18,1
28,532,04321,0,1,50,26,9,6,11,11,0,18,3,50,63465,21,17,11,35,1
28,532,04322,0,0,0,22,4,1,1,0,0,19,3,12,52835,22,2,0,26,0
28,532,04323,0,0,0,13,0,2,0,0,0,12,0,0,28911,12,2,0,13,0
28,532,04324,0,0,0,22,0,4,0,0,0,26,0,0,48106,26,4,0,22,0
28,532,04325,0,0,0,14,0,2,0,0,0,16,0,0,29623,16,2,0,14,0
28,532,04326,0,0,0,16,0,4,0,0,0,10,0,0,26097,10,4,0,16,0
28,532,04327,0,0,0,19,0,5,0,0,0,13,0,0,35826,13,5,0,19,0
28,532,04328,0,0,0,62,0,2,0,0,0,30,0,0,26285,30,2,0,62,0
28,532,04329,0,0,0,61,0,2,0,0,0,32,0,0,34712,32,2,0,61,0
28,532,04330,0,0,0,19,0,2,0,0,0,14,0,0,19532,14,2,0,19,0
28,532,04331,0,0,0,25,0,3,0,0,0,9,0,0,23534,9,3,0,25,0
28,532,04332,1,0,0,24,0,7,0,0,2,30,0,0,32617,30,7,2,24,1
28,532,04333,0,0,0,32,0,8,0,0,0,16,0,0,26389,16,8,0,32,0
28,532,04334,0,0,0,15,0,1,0,0,0,14,0,0,52883,14,1,0,15,0
28,532,04335,0,0,0,18,0,4,0,0,0,12,0,0,52692,12,4,0,18,0
28,532,04336,0,0,0,12,0,1,0,0,0,10,0,0,48820,10,1,0,12,0
28,532,04337,0,0,0,8,0,1,0,0,0,9,0,0,34190,9,1,0,8,0
28,532,04338,0,0,0,17,0,4,0,0,0,15,0,0,47984,15,4,0,17,0
28,532,04339,0,1,100,7,33,0,14,12,0,7,5,123,89417,12,14,12,40,1
28,532,04340,0,0,0,13,0,2,0,0,0,10,0,0,39752,10,2,0,13,0
28,532,04341,0,0,0,26,0,5,0,0,0,18,0,0,55922,18,5,0,26,0
28,532,04342,0,0,0,14,0,3,0,0,0,10,0,0,34253,10,3,0,14,0
28,532,04343,0,0,0,12,0,2,0,0,0,9,0,0,35780,9,2,0,12,0
28,532,04344,0,1,50,15,23,2,7,5,0,21,6,70,139543,27,9,5,38,1
28,532,04345,0,0,0,22,0,3,0,0,0,14,0,0,36739,14,3,0,22,0
28,532,04346,0,0,0,10,0,2,0,0,0,7,0,0,32303,7,2,0,10,0
28,532,04347,0,1,50,21,12,5,3,3,0,23,2,50,61944,25,8,3,33,1
28,532,04348,0,0,0,20,0,3,0,0,0,28,0,0,49727,28,3,0,20,0
28,532,04349,0,1,30,11,10,2,4,3,0,8,2,38,32716,10,6,3,21,1
28,532,04350,0,2,105,6,16,0,21,19,0,11,4,125,80897,15,21,19,22,2
28,532,04351,0,0,0,14,0,2,0,0,0,19,0,0,33110,19,2,0,14,0
28,532,04352,0,2,60,8,39,0,11,7,0,8,6,96,100109,14,11,7,47,2
28,532,04353,0,1,36,30,11,2,3,3,0,21,2,36,50674,23,5,3,41,1
28,532,04354,0,1,85,18,19,2,15,10,0,18,11,120,195228,29,17,10,37,1
28,532,04355,0,0,0,19,0,4,0,0,0,37,0,0,50079,37,4,0,19,0
28,532,04356,0,0,0,15,7,1,1,0,0,12,2,10,54692,14,2,0,22,0
28,533,04357,0,0,0,14,0,2,0,0,0,9,0,0,38880,9,2,0,14,0
28,533,04358,0,0,0,108,0,5,0,0,0,40,0,0,55125,40,5,0,108,0
28,533,04359,0,0,0,27,0,4,0,0,0,27,0,0,70598,27,4,0,27,0
28,533,04360,0,0,0,15,10,1,5,0,0,12,7,30,121987,19,6,0,25,0
28,533,04361,0,0,0,80,0,6,0,0,0,30,0,0,81003,30,6,0,80,0
28,533,04362,0,0,0,73,0,5,0,0,0,31,0,0,56153,31,5,0,73,0
28,533,04363,0,0,0,19,0,1,0,0,0,18,0,0,42765,18,1,0,19,0
28,533,04364,0,0,0,27,0,1,0,0,0,16,0,0,62623,16,1,0,27,0
28,533,04365,0,0,0,76,0,1,0,0,0,27,0,0,42486,27,1,0,76,0
28,533,04366,0,0,0,17,0,1,0,0,0,10,0,0,45505,10,1,0,17,0
28,533,04367,0,0,0,28,0,2,0,0,0,15,0,0,58588,15,2,0,28,0
28,533,04368,0,1,100,43,74,2,29,12,0,24,13,257,412500,37,31,12,117,1
28,533,04369,0,0,0,19,0,2,0,0,0,9,0,0,40028,9,2,0,19,0
28,533,04370,0,1,100,27,20,3,10,8,0,13,3,110,143749,16,13,8,47,1
28,533,04371,0,0,0,30,0,5,0,0,0,13,0,0,56917,13,5,0,30,0
28,533,04372,0,0,0,38,0,10,0,0,0,17,0,0,59002,17,10,0,38,0
28,533,04373,0,0,0,29,0,2,0,0,0,15,0,0,53980,15,2,0,29,0
28,533,04374,0,0,0,32,0,5,0,0,0,38,0,0,64044,38,5,0,32,0
28,533,04375,0,0,0,36,0,2,0,0,0,14,0,0,50391,14,2,0,36,0
28,533,04376,0,0,0,49,0,8,0,0,0,18,0,0,72230,18,8,0,49,0
28,533,04377,0,0,0,34,0,5,0,0,0,19,0,0,76896,19,5,0,34,0
28,533,04378,0,0,0,47,0,6,0,0,0,51,0,0,47954,51,6,0,47,0
28,533,04379,0,0,0,26,0,1,0,0,0,14,0,0,51078,14,1,0,26,0
28,533,04380,0,0,0,25,0,2,0,0,0,14,0,0,58443,14,2,0,25,0
28,533,04381,0,0,0,27,0,4,0,0,0,13,0,0,56005,13,4,0,27,0
28,533,04382,0,0,0,31,0,7,0,0,0,14,0,0,58535,14,7,0,31,0
28,533,04383,0,1,30,17,8,1,3,3,0,9,2,30,68722,11,4,3,25,1
28,533,04384,0,0,0,26,0,5,0,0,0,13,0,0,47581,13,5,0,26,0
28,533,04385,0,0,0,20,0,1,0,0,0,10,0,0,36874,10,1,0,20,0
28,533,04386,0,1,30,14,10,1,5,5,0,8,3,30,46253,11,6,5,24,1
28,533,04387,0,0,0,16,0,1,0,0,0,10,0,0,34601,10,1,0,16,0
28,533,04388,0,0,0,19,0,2,0,0,0,12,0,0,48122,12,2,0,19,0
28,533,04389,0,0,0,21,0,1,0,0,0,10,0,0,48585,10,1,0,21,0
28,533,04390,0,1,100,17,35,1,12,8,0,9,10,134,126445,19,13,8,52,1
28,533,04391,0,0,0,28,0,3,0,0,0,15,0,0,59656,15,3,0,28,0
28,533,04392,0,0,0,30,0,6,0,0,0,15,0,0,56939,15,6,0,30,0
28,534,04393,0,0,0,43,0,2,0,0,0,91,0,0,52759,91,2,0,43,0
28,534,04394,0,0,0,55,0,4,0,0,0,23,0,0,53870,23,4,0,55,0
28,534,04395,0,0,0,27,0,6,0,0,0,20,0,0,63907,20,6,0,27,0
28,534,04396,0,0,0,25,0,1,0,0,0,12,0,0,45006,12,1,0,25,0
28,534,04397,0,0,0,33,0,6,0,0,0,20,0,0,78330,20,6,0,33,0
28,534,04398,0,0,0,27,0,2,0,0,0,12,0,0,51719,12,2,0,27,0
28,534,04399,0,2,98,14,33,1,12,9,0,10,9,128,277041,19,13,9,47,2
28,534,04400,0,0,0,37,0,3,0,0,0,17,0,0,69652,17,3,0,37,0
28,534,04401,0,0,0,31,0,7,0,0,0,14,0,0,54669,14,7,0,31,0
28,534,04402,0,0,0,17,0,2,0,0,0,13,0,0,37327,13,2,0,17,0
28,534,04403,0,0,0,29,0,4,0,0,0,49,0,0,38489,49,4,0,29,0
28,534,04404,0,0,0,18,0,1,0,0,0,22,0,0,26312,22,1,0,18,0
28,534,04405,0,0,0,14,0,2,0,0,0,9,0,0,25343,9,2,0,14,0
28,534,04406,0,0,0,11,0,1,0,0,0,8,0,0,31567,8,1,0,11,0
28,534,04407,0,0,0,73,0,6,0,0,0,25,0,0,41956,25,6,0,73,0
28,534,04408,0,1,50,32,26,2,10,5,0,17,9,100,101776,26,12,5,58,1
28,534,04409,0,0,0,14,0,1,0,0,0,25,0,0,27661,25,1,0,14,0
28,534,04410,0,0,0,10,0,1,0,0,0,5,0,0,22342,5,1,0,10,0
28,534,04411,0,0,0,18,0,1,0,0,0,18,0,0,54087,18,1,0,18,0
28,534,04412,0,0,0,20,0,1,0,0,0,13,0,0,44951,13,1,0,20,0
28,534,04413,0,0,0,14,0,2,0,0,0,10,0,0,47373,10,2,0,14,0
28,534,04414,0,1,100,36,33,2,15,10,0,19,11,132,169064,30,17,10,69,1
28,534,04415,0,0,0,19,0,1,0,0,0,11,0,0,51209,11,1,0,19,0
28,534,04416,0,1,30,13,14,1,5,3,0,34,15,39,108346,49,6,3,27,1
28,534,04417,0,1,50,11,18,1,7,5,0,7,17,55,86692,24,8,5,29,1
28,534,04418,0,0,0,17,0,2,0,0,0,10,0,0,43986,10,2,0,17,0
28,534,04419,0,0,0,17,0,1,0,0,0,9,0,0,43596,9,1,0,17,0
28,534,04420,0,0,0,14,0,3,0,0,0,12,0,0,43685,12,3,0,14,0
28,534,04421,0,0,0,65,0,6,0,0,0,44,0,0,47981,44,6,0,65,0
28,534,04422,0,0,0,69,0,15,0,0,0,31,0,0,49251,31,15,0,69,0
28,534,04423,0,0,0,30,0,4,0,0,0,14,0,0,48253,14,4,0,30,0
28,534,04424,0,0,0,59,0,6,0,0,0,21,0,0,51288,21,6,0,59,0
28,534,04425,0,0,0,44,0,10,0,0,0,15,0,0,63454,15,10,0,44,0
28,534,04426,0,0,0,50,0,8,0,0,0,21,0,0,42211,21,8,0,50,0
28,534,04427,0,0,0,69,0,4,0,0,0,31,0,0,67854,31,4,0,69,0
28,534,04428,0,1,350,24,96,2,51,29,0,17,45,542,363106,62,53,29,120,1
28,534,04429,0,0,0,34,0,4,0,0,0,23,0,0,39240,23,4,0,34,0
28,534,04430,0,1,20,11,17,0,4,2,0,9,18,30,80475,27,4,2,28,1
28,534,04431,0,0,0,12,0,2,0,0,0,9,0,0,40857,9,2,0,12,0
28,534,04432,0,0,0,67,0,1,0,0,0,35,0,0,59633,35,1,0,67,0
28,534,04433,0,0,0,24,0,6,0,0,0,14,0,0,46838,14,6,0,24,0
28,534,04434,0,0,0,12,0,1,0,0,0,15,0,0,44217,15,1,0,12,0
28,534,04435,0,1,100,51,27,3,12,8,0,22,9,122,142676,31,15,8,78,1
28,534,04436,0,0,0,22,0,1,0,0,0,18,0,0,51278,18,1,0,22,0
28,534,04437,0,0,0,69,0,2,0,0,0,30,0,0,53945,30,2,0,69,0
28,534,04438,0,0,0,28,0,1,0,0,0,15,0,0,42862,15,1,0,28,0
28,534,04439,0,0,0,63,0,1,0,0,0,24,0,0,49041,24,1,0,63,0
28,534,04440,0,0,0,62,4,10,0,0,0,29,1,0,103429,30,10,0,66,0
28,534,04441,0,0,0,25,0,1,0,0,0,11,0,0,45302,11,1,0,25,0
28,534,04442,0,0,0,19,0,2,0,0,0,11,0,0,41859,11,2,0,19,0
28,534,04443,0,0,0,14,0,1,0,0,0,10,0,0,44645,10,1,0,14,0
28,534,04444,0,0,0,47,0,7,0,0,0,28,0,0,78793,28,7,0,47,0
28,534,04445,0,0,0,27,0,1,0,0,0,12,0,0,40801,12,1,0,27,0
28,534,04446,0,0,0,33,0,6,0,0,0,14,0,0,74721,14,6,0,33,0
28,534,04447,0,0,0,72,0,2,0,0,0,30,0,0,61413,30,2,0,72,0
28,534,04448,0,0,0,37,0,7,0,0,0,18,0,0,55886,18,7,0,37,0
28,534,04449,0,0,0,31,0,3,0,0,0,13,0,0,40577,13,3,0,31,0
28,535,04450,0,0,0,17,0,3,0,0,0,13,0,0,52572,13,3,0,17,0
28,535,04451,0,0,0,23,0,6,0,0,0,12,0,0,59501,12,6,0,23,0
28,535,04452,0,0,0,20,9,3,2,0,0,10,5,30,82127,15,5,0,29,0
28,535,04453,0,0,0,27,0,4,0,0,0,9,0,0,51486,9,4,0,27,0
28,535,04454,0,0,0,4,3,0,0,0,0,2,1,0,41153,3,0,0,7,0
28,535,04455,0,0,0,58,0,3,0,0,0,25,0,0,57149,25,3,0,58,0
28,535,04456,0,1,90,30,59,3,16,10,0,13,7,150,115177,20,19,10,89,1
28,535,04457,0,0,0,33,0,3,0,0,0,24,0,0,68846,24,3,0,33,0
28,535,04458,0,0,0,54,0,6,0,0,0,23,0,0,71847,23,6,0,54,0
28,535,04459,0,2,110,34,90,4,23,10,0,13,31,237,172878,44,27,10,124,2
28,535,04460,0,0,0,33,0,2,0,0,0,19,0,0,58271,19,2,0,33,0
28,535,04461,0,0,0,29,0,2,0,0,0,12,0,0,41794,12,2,0,29,0
28,535,04462,0,0,0,39,0,4,0,0,0,17,0,0,48592,17,4,0,39,0
28,535,04463,0,0,0,21,0,2,0,0,0,9,0,0,34488,9,2,0,21,0
28,535,04464,0,0,0,26,0,4,0,0,0,14,0,0,42002,14,4,0,26,0
28,535,04465,0,0,0,45,0,10,0,0,0,17,0,0,53822,17,10,0,45,0
28,535,04466,0,0,0,18,5,2,1,0,0,13,3,10,58865,16,3,0,23,0
28,535,04467,0,0,0,31,0,3,0,0,0,13,0,0,44994,13,3,0,31,0
28,535,04468,0,0,0,29,0,2,0,0,0,14,0,0,35910,14,2,0,29,0
28,535,04469,0,0,0,23,0,2,0,0,0,11,0,0,37879,11,2,0,23,0
28,535,04470,0,0,0,27,0,2,0,0,0,9,0,0,47678,9,2,0,27,0
28,535,04471,0,0,0,23,0,2,0,0,0,9,0,0,36167,9,2,0,23,0
28,535,04472,0,0,0,21,0,2,0,0,0,11,0,0,40732,11,2,0,21,0
28,535,04473,0,0,0,36,0,6,0,0,0,15,0,0,57110,15,6,0,36,0
28,535,04474,0,1,50,41,52,6,16,5,0,25,6,153,169451,31,22,5,93,1
28,535,04475,0,0,0,44,0,6,0,0,0,16,0,0,60638,16,6,0,44,0
28,535,04476,0,0,0,25,0,4,0,0,0,18,0,0,44583,18,4,0,25,0
28,535,04477,0,0,0,27,0,2,0,0,0,15,0,0,40965,15,2,0,27,0
28,535,04478,0,0,0,32,0,3,0,0,0,15,0,0,51386,15,3,0,32,0
28,535,04479,0,0,0,18,13,2,7,0,0,12,18,70,63536,30,9,0,31,0
28,535,04480,0,0,0,27,0,2,0,0,0,16,0,0,55518,16,2,0,27,0
28,535,04481,0,0,0,20,0,2,0,0,0,21,0,0,42309,21,2,0,20,0
28,535,04482,0,0,0,24,0,4,0,0,0,17,0,0,60580,17,4,0,24,0
28,535,04483,0,1,50,21,33,2,12,4,0,13,3,110,77264,16,14,4,54,1
28,535,04484,0,0,0,34,0,6,0,0,0,13,0,0,47093,13,6,0,34,0
28,535,04485,0,0,0,23,0,2,0,0,0,11,0,0,44525,11,2,0,23,0
28,535,04486,0,0,0,26,0,4,0,0,0,12,0,0,44039,12,4,0,26,0
28,535,04487,0,0,0,19,0,2,0,0,0,12,0,0,45132,12,2,0,19,0
28,535,04488,0,0,0,26,0,3,0,0,0,28,0,0,53774,28,3,0,26,0
28,535,04489,0,0,0,46,0,8,0,0,0,29,0,0,55935,29,8,0,46,0
28,535,04490,0,0,0,11,9,3,3,0,0,11,8,30,94337,19,6,0,20,0
28,535,04491,0,0,0,19,0,2,0,0,0,8,0,0,42985,8,2,0,19,0
28,535,04492,0,1,250,21,123,2,57,33,0,13,36,470,154578,49,59,33,144,1
28,535,04493,0,0,0,48,11,6,1,0,0,19,5,10,97279,24,7,0,59,0
28,535,04494,0,2,168,10,68,0,17,14,0,8,22,190,159191,30,17,14,78,2
28,535,04495,0,0,0,4,3,0,0,0,0,2,1,0,25283,3,0,0,7,0
28,536,04499,0,1,220,0,85,0,27,15,0,0,47,220,217910,47,27,15,85,1
28,536,04501,0,1,110,0,32,0,13,8,0,0,4,110,6762,4,13,8,32,1
28,536,04505,0,17,7097,0,3728,0,1575,1197,0,0,1371,10613,271385,1371,1575,1197,3728,17
28,537,04512,0,0,0,72,0,6,0,0,0,30,0,0,51090,30,6,0,72,0
28,537,04513,0,0,0,12,0,2,0,0,0,12,0,0,43261,12,2,0,12,0
28,537,04514,0,0,0,15,0,2,0,0,0,14,0,0,41283,14,2,0,15,0
28,537,04515,0,0,0,40,0,5,0,0,0,19,0,0,65428,19,5,0,40,0
28,537,04518,0,0,0,0,3,0,1,0,0,0,2,10,58034,2,1,0,3,0
28,537,04519,0,1,30,59,32,1,8,3,0,33,19,100,93425,52,9,3,91,1
28,537,04520,0,0,0,39,0,6,0,0,0,42,58,0,117172,100,6,0,39,0
28,537,04522,0,0,0,8,2,1,1,0,0,5,0,10,57958,5,2,0,10,0
28,537,04523,1,1,30,25,28,2,5,4,2,21,11,40,157332,32,7,6,53,2
28,537,04525,0,0,0,48,8,0,0,0,0,34,2,0,72639,36,0,0,56,0
28,537,04526,0,4,500,0,154,0,77,50,0,0,102,770,549004,102,77,50,154,4
28,537,04527,0,0,0,15,6,2,1,0,0,16,1,10,54046,17,3,0,21,0
28,537,04528,0,0,0,50,0,2,0,0,0,38,0,0,56205,38,2,0,50,0
28,537,04529,0,0,0,91,0,7,0,0,0,40,0,0,58166,40,7,0,91,0
28,537,04530,0,1,50,13,70,1,19,5,0,9,14,220,85410,23,20,5,83,1
28,537,04531,0,0,0,14,0,1,0,0,0,21,0,0,44900,21,1,0,14,0
28,537,04532,0,0,0,11,0,1,0,0,0,7,0,0,33159,7,1,0,11,0
28,537,04533,0,0,0,42,0,3,0,0,0,36,0,0,51893,36,3,0,42,0
28,537,04534,0,1,100,75,15,1,10,10,0,28,13,100,118773,41,11,10,90,1
28,537,04535,0,0,0,16,0,1,0,0,0,10,1,0,43562,11,1,0,16,0
28,537,04536,0,0,0,12,0,1,0,0,0,15,0,0,45295,15,1,0,12,0
28,537,04537,0,0,0,11,0,1,0,0,0,10,0,0,48224,10,1,0,11,0
28,537,04538,0,0,0,70,0,3,0,0,0,40,0,0,70387,40,3,0,70,0
28,537,04539,0,0,0,16,0,1,0,0,0,15,0,0,70281,15,1,0,16,0
28,537,04540,1,0,0,17,0,3,0,0,1,17,0,0,62975,17,3,1,17,1
28,537,04541,0,0,0,20,0,3,0,0,0,10,0,0,44884,10,3,0,20,0
28,537,04542,0,0,0,11,0,1,0,0,0,17,0,0,51319,17,1,0,11,0
28,537,04543,0,1,12,13,24,2,7,1,0,12,10,67,85299,22,9,1,37,1
28,537,04544,0,0,0,75,0,5,0,0,0,51,0,0,65091,51,5,0,75,0
28,537,04545,0,0,0,50,0,3,0,0,0,27,0,0,54587,27,3,0,50,0
28,537,04546,0,1,30,48,16,4,4,3,0,31,2,40,73985,33,8,3,64,1
28,537,04547,0,0,0,48,0,1,0,0,0,32,0,0,46488,32,1,0,48,0
28,537,04548,0,0,0,13,0,1,0,0,0,21,0,0,49409,21,1,0,13,0
28,538,04549,0,0,0,95,0,4,0,0,0,28,0,0,53673,28,4,0,95,0
28,538,04550,0,0,0,59,0,2,0,0,0,34,0,0,55937,34,2,0,59,0
28,538,04551,0,0,0,34,0,5,0,0,0,21,0,0,57495,21,5,0,34,0
28,538,04552,0,0,0,12,0,2,0,0,0,18,0,0,51497,18,2,0,12,0
28,538,04553,0,0,0,26,0,1,0,0,0,15,0,0,57946,15,1,0,26,0
28,538,04554,0,0,0,13,0,1,0,0,0,13,0,0,67395,13,1,0,13,0
28,538,04555,0,0,0,29,0,6,0,0,0,22,0,0,55044,22,6,0,29,0
28,538,04556,0,0,0,47,0,2,0,0,0,24,0,0,52061,24,2,0,47,0
28,538,04557,0,0,0,164,0,2,0,0,0,58,0,0,66668,58,2,0,164,0
28,538,04558,0,0,0,8,0,2,0,0,0,7,0,0,60518,7,2,0,8,0
28,538,04559,0,1,100,48,19,2,9,6,0,46,3,130,112633,49,11,6,67,1
28,538,04560,0,0,0,17,0,3,0,0,0,33,0,0,65241,33,3,0,17,0
28,538,04561,0,0,0,28,0,3,0,0,0,25,0,0,42592,25,3,0,28,0
28,538,04562,0,0,0,33,0,3,0,0,0,15,0,0,52835,15,3,0,33,0
28,538,04563,0,0,0,39,0,6,0,0,0,17,0,0,62021,17,6,0,39,0
28,538,04564,0,0,0,31,0,2,0,0,0,17,0,0,49133,17,2,0,31,0
28,538,04565,0,0,0,23,0,1,0,0,0,14,0,0,46006,14,1,0,23,0
28,538,04566,0,0,0,30,0,2,0,0,0,11,0,0,52352,11,2,0,30,0
28,538,04567,0,1,30,19,17,1,6,3,0,22,5,60,102766,27,7,3,36,1
28,538,04568,0,1,250,80,175,1,52,28,0,28,19,500,249091,47,53,28,255,1
28,538,04569,0,0,0,49,0,6,0,0,0,17,0,0,66677,17,6,0,49,0
28,538,04570,0,1,30,21,13,1,3,3,0,21,8,30,97838,29,4,3,34,1
28,538,04571,0,0,0,19,0,2,0,0,0,9,0,0,55885,9,2,0,19,0
28,538,04572,0,0,0,13,0,3,0,0,0,11,0,0,64039,11,3,0,13,0
28,538,04573,0,0,0,37,0,4,0,0,0,20,0,0,58385,20,4,0,37,0
28,538,04574,0,0,0,11,0,1,0,0,0,11,0,0,49777,11,1,0,11,0
28,538,04575,0,0,0,33,0,2,0,0,0,14,0,0,40424,14,2,0,33,0
28,538,04576,0,1,50,18,18,2,5,5,0,8,4,50,64095,12,7,5,36,1
28,538,04577,0,0,0,63,0,8,0,0,0,25,0,0,50113,25,8,0,63,0
28,538,04578,0,0,0,27,4,2,0,0,0,11,1,0,50133,12,2,0,31,0
28,538,04579,0,1,30,21,15,3,4,3,0,12,3,40,69875,15,7,3,36,1
28,538,04580,0,0,0,18,0,3,0,0,0,7,0,0,34225,7,3,0,18,0
28,538,04581,0,0,0,80,0,8,0,0,0,29,0,0,49585,29,8,0,80,0
28,538,04582,0,0,0,86,0,0,0,0,0,34,0,0,38375,34,0,0,86,0
28,538,04583,0,1,100,83,39,4,10,8,0,30,10,140,74728,40,14,8,122,1
28,538,04584,0,0,0,64,0,10,0,0,0,28,0,0,72647,28,10,0,64,0
28,538,04585,0,0,0,24,0,2,0,0,0,11,0,0,48771,11,2,0,24,0
28,538,04586,0,0,0,87,0,3,0,0,0,29,0,0,52381,29,3,0,87,0
28,538,04587,0,0,0,7,0,0,0,0,0,8,0,0,50341,8,0,0,7,0
28,538,04588,0,0,0,39,0,5,0,0,0,22,0,0,49359,22,5,0,39,0
28,538,04589,0,0,0,27,0,4,0,0,0,20,0,0,72028,20,4,0,27,0
28,538,04590,0,0,0,95,0,2,0,0,0,46,0,0,47957,46,2,0,95,0
28,538,04591,0,0,0,12,0,1,0,0,0,11,0,0,65945,11,1,0,12,0
28,538,04592,0,1,30,14,13,1,6,3,0,11,9,70,61505,20,7,3,27,1
28,538,04593,0,1,30,24,16,2,5,2,0,15,4,60,79604,19,7,2,40,1
28,538,04594,0,0,0,26,0,2,0,0,0,11,0,0,40303,11,2,0,26,0
28,538,04595,0,1,100,73,33,1,14,10,0,32,10,140,108521,42,15,10,106,1
28,538,04596,0,0,0,40,0,5,0,0,0,24,0,0,59307,24,5,0,40,0
28,538,04597,0,0,0,25,0,3,0,0,0,10,0,0,38768,10,3,0,25,0
28,538,04598,0,0,0,14,0,3,0,0,0,11,0,0,34979,11,3,0,14,0
28,538,04599,0,0,0,70,0,2,0,0,0,31,0,0,56461,31,2,0,70,0
28,538,04600,0,0,0,29,0,2,0,0,0,17,0,0,44986,17,2,0,29,0
28,538,04601,0,0,0,28,0,1,0,0,0,18,0,0,60254,18,1,0,28,0
28,538,04602,0,0,0,37,0,2,0,0,0,18,0,0,68690,18,2,0,37,0
28,538,04603,0,1,100,68,41,0,13,9,0,25,1,140,114390,26,13,9,109,1
28,538,04604,0,0,0,24,0,2,0,0,0,19,0,0,52579,19,2,0,24,0
28,538,04605,0,0,0,25,0,2,0,0,0,23,0,0,72930,23,2,0,25,0
28,538,04606,0,0,0,70,0,3,0,0,0,33,0,0,85303,33,3,0,70,0
28,538,04607,0,0,0,12,0,2,0,0,0,19,0,0,52926,19,2,0,12,0
28,538,04608,0,0,0,72,0,1,0,0,0,30,0,0,51336,30,1,0,72,0
28,538,04609,0,0,0,55,0,5,0,0,0,30,0,0,67687,30,5,0,55,0
28,538,04610,0,0,0,33,0,3,0,0,0,28,0,0,69445,28,3,0,33,0
28,538,04611,0,0,0,28,0,2,0,0,0,20,0,0,51515,20,2,0,28,0
28,538,04612,0,0,0,26,0,4,0,0,0,12,0,0,44882,12,4,0,26,0
28,539,04613,0,0,0,21,0,2,0,0,0,10,0,0,37248,10,2,0,21,0
28,539,04614,0,0,0,21,0,2,0,0,0,8,0,0,33797,8,2,0,21,0
28,539,04615,0,0,0,62,0,2,0,0,0,23,1,0,38454,24,2,0,62,0
28,539,04616,0,0,0,26,12,2,3,0,0,10,6,10,54491,16,5,0,38,0
28,539,04617,0,0,0,31,0,5,0,0,0,18,0,0,47365,18,5,0,31,0
28,539,04618,0,0,0,37,0,1,0,0,0,13,0,0,36190,13,1,0,37,0
28,539,04619,0,0,0,29,0,2,0,0,0,16,0,0,47657,16,2,0,29,0
28,539,04620,1,0,0,44,0,4,0,0,3,21,0,0,57905,21,4,3,44,1
28,539,04621,0,0,0,31,0,1,0,0,0,11,0,0,56991,11,1,0,31,0
28,539,04622,0,0,0,10,0,1,0,0,0,9,0,0,50945,9,1,0,10,0
28,539,04623,0,0,0,31,0,3,0,0,0,12,0,0,40785,12,3,0,31,0
28,539,04624,0,0,0,35,0,4,0,0,0,14,0,0,47075,14,4,0,35,0
28,539,04625,0,0,0,107,0,5,0,0,0,37,0,0,55694,37,5,0,107,0
28,539,04626,0,0,0,56,0,1,0,0,0,20,0,0,39194,20,1,0,56,0
28,539,04627,0,0,0,104,0,5,0,0,0,36,0,0,56098,36,5,0,104,0
28,539,04628,0,1,100,23,28,1,13,10,0,13,5,120,103538,18,14,10,51,1
28,539,04629,0,0,0,32,2,1,1,0,0,13,3,0,48498,16,2,0,34,0
28,539,04630,0,0,0,59,3,0,1,0,0,23,5,0,51061,28,1,0,62,0
28,539,04631,0,0,0,62,16,0,4,0,0,23,10,40,73336,33,4,0,78,0
28,539,04632,0,0,0,26,10,1,5,0,0,10,1,50,51534,11,6,0,36,0
28,539,04633,0,0,0,44,0,1,0,0,0,16,0,0,55600,16,1,0,44,0
28,539,04634,0,0,0,49,0,2,0,0,0,18,0,0,50864,18,2,0,49,0
28,539,04635,0,0,0,48,0,1,0,0,0,19,0,0,46811,19,1,0,48,0
28,539,04636,0,0,0,24,14,0,3,0,0,10,3,30,60758,13,3,0,38,0
28,539,04637,0,0,0,57,0,2,0,0,0,20,0,0,37533,20,2,0,57,0
28,539,04638,0,1,100,26,32,1,12,10,0,12,5,110,155422,17,13,10,58,1
28,539,04639,0,0,0,54,0,1,0,0,0,20,0,0,47835,20,1,0,54,0
28,539,04640,0,0,0,24,0,1,0,0,0,11,0,0,44132,11,1,0,24,0
28,539,04641,1,0,0,46,0,3,0,0,1,20,0,0,39335,20,3,1,46,1
28,539,04642,0,0,0,48,0,1,0,0,0,19,0,0,43824,19,1,0,48,0
28,539,04643,1,0,0,25,0,4,0,0,2,11,0,0,39624,11,4,2,25,1
28,539,04644,0,0,0,52,0,4,0,0,0,19,0,0,44520,19,4,0,52,0
28,539,04645,0,0,0,99,0,2,0,0,0,29,0,0,47788,29,2,0,99,0
28,539,04646,0,1,250,85,119,0,43,25,0,26,12,420,200067,38,43,25,204,1
28,539,04647,0,0,0,78,0,2,0,0,0,27,0,0,45477,27,2,0,78,0
28,539,04648,0,0,0,60,0,2,0,0,0,22,0,0,44335,22,2,0,60,0
28,539,04649,0,0,0,13,0,2,0,0,0,8,0,0,36968,8,2,0,13,0
28,539,04650,0,0,0,27,0,4,0,0,0,15,0,0,45058,15,4,0,27,0
28,539,04651,0,0,0,54,0,1,0,0,0,26,0,0,46380,26,1,0,54,0
28,539,04652,0,0,0,43,0,1,0,0,0,22,0,0,51408,22,1,0,43,0
28,539,04653,0,0,0,41,16,0,6,0,0,24,4,50,99384,28,6,0,57,0
28,539,04654,0,0,0,61,0,1,0,0,0,23,0,0,41203,23,1,0,61,0
28,539,04655,0,0,0,14,0,0,0,0,0,8,1,0,48866,9,0,0,14,0
28,539,04656,0,0,0,75,0,2,0,0,0,29,0,0,44029,29,2,0,75,0
28,539,04657,0,0,0,25,0,2,0,0,0,13,0,0,43280,13,2,0,25,0
28,539,04658,0,0,0,43,0,4,0,0,0,17,0,0,50338,17,4,0,43,0
28,539,04659,0,0,0,31,6,1,2,0,0,14,2,10,67959,16,3,0,37,0
28,539,04660,0,0,0,31,0,2,0,0,0,16,0,0,63740,16,2,0,31,0
28,539,04661,0,0,0,60,0,3,0,0,0,35,0,0,53816,35,3,0,60,0
28,539,04662,0,0,0,37,0,3,0,0,0,13,0,0,46627,13,3,0,37,0
28,539,04663,0,0,0,34,0,1,0,0,0,15,0,0,66946,15,1,0,34,0
28,539,04664,0,1,100,39,31,3,12,9,0,17,9,130,175838,26,15,9,70,1
28,539,04665,0,0,0,32,0,3,0,0,0,18,0,0,66499,18,3,0,32,0
28,539,04666,0,0,0,40,0,3,0,0,0,19,0,0,56179,19,3,0,40,0
28,539,04667,0,0,0,28,0,2,0,0,0,12,0,0,39225,12,2,0,28,0
28,539,04668,0,0,0,41,16,2,4,0,0,20,5,40,133130,25,6,0,57,0
28,539,04669,0,0,0,24,0,5,0,0,0,15,0,0,60426,15,5,0,24,0
28,539,04670,0,0,0,25,0,2,0,0,0,17,0,0,44939,17,2,0,25,0
28,539,04671,0,0,0,75,0,2,0,0,0,27,0,0,74682,27,2,0,75,0
28,540,04672,0,0,0,58,0,6,0,0,0,29,0,0,70809,29,6,0,58,0
28,540,04673,0,0,0,50,0,2,0,0,0,23,0,0,38731,23,2,0,50,0
28,540,04674,3,0,0,68,0,6,0,0,3,30,0,0,44265,30,6,3,68,3
28,540,04675,0,0,0,30,0,1,0,0,0,16,0,0,42374,16,1,0,30,0
28,540,04676,0,0,0,51,4,4,0,0,0,26,11,0,92303,37,4,0,55,0
28,540,04677,0,0,0,46,0,4,0,0,0,21,0,0,70640,21,4,0,46,0
28,540,04678,0,0,0,15,0,1,0,0,0,11,1,0,53205,12,1,0,15,0
28,540,04679,1,0,0,47,0,11,0,0,1,33,0,0,80542,33,11,1,47,1
28,540,04680,0,0,0,53,0,6,0,0,0,24,0,0,39387,24,6,0,53,0
28,540,04681,1,0,0,94,0,5,0,0,1,36,0,0,61813,36,5,1,94,1
28,540,04682,0,1,20,47,9,1,2,2,0,19,1,20,86729,20,3,2,56,1
28,540,04683,0,0,0,28,0,5,0,0,0,10,0,0,35952,10,5,0,28,0
28,540,04684,1,0,0,35,0,8,0,0,1,17,0,0,38959,17,8,1,35,1
28,540,04685,1,0,0,135,0,11,0,0,1,51,0,0,41153,51,11,1,135,1
28,540,04686,0,0,0,56,0,2,0,0,0,22,3,0,48420,25,2,0,56,0
28,540,04687,1,0,0,118,0,3,0,0,1,42,0,0,22823,42,3,1,118,1
28,540,04688,0,0,0,29,0,5,0,0,0,13,0,0,30738,13,5,0,29,0
28,540,04689,0,0,0,61,0,8,0,0,0,28,0,0,61741,28,8,0,61,0
28,540,04690,0,0,0,42,0,3,0,0,0,20,0,0,59602,20,3,0,42,0
28,540,04691,0,0,0,37,0,3,0,0,0,15,0,0,40292,15,3,0,37,0
28,540,04692,0,0,0,56,0,2,0,0,0,20,0,0,37503,20,2,0,56,0
28,540,04693,1,0,0,59,0,4,0,0,1,20,0,0,42050,20,4,1,59,1
28,540,04694,0,0,0,62,0,3,0,0,0,23,0,0,59540,23,3,0,62,0
28,540,04695,1,0,29.375,26,111,3,6.3125,2.9375,1,14,20,409.375,427303,34,9.3125,3.9375,137,1
28,540,04696,0,0,0,49,0,3,0,0,0,20,0,0,45899,20,3,0,49,0
28,540,04697,1,0,0,52,0,5,0,0,1,26,0,0,58194,26,5,1,52,1
28,540,04698,0,0,0,57,0,6,0,0,0,22,0,0,53374,22,6,0,57,0
28,540,04699,0,1,100,43,31,0,14,10,0,19,64,120,92446,83,14,10,74,1
28,540,04700,0,0,0,29,0,1,0,0,0,14,0,0,38340,14,1,0,29,0
28,540,04701,0,0,0,32,0,2,0,0,0,14,0,0,42411,14,2,0,32,0
28,540,04702,0,0,0,41,0,3,0,0,0,18,0,0,51816,18,3,0,41,0
28,540,04703,0,0,0,42,0,2,0,0,0,19,0,0,56189,19,2,0,42,0
28,540,04704,2,0,0,77,0,12,0,0,2,34,0,0,76873,34,12,2,77,2
28,540,04705,1,0,0,41,0,4,0,0,1,24,0,0,53160,24,4,1,41,1
28,540,04706,0,1,200,0,50,0,26,20,0,0,4,300,297078,4,26,20,50,1
28,540,04707,5,0,0,59,0,11,0,0,5,23,1,0,52332,24,11,5,59,5
28,540,04708,0,1,50,30,18,3,10,5,0,13,9,100,67239,22,13,5,48,1
28,540,04709,0,0,0,30,0,4,0,0,0,13,0,0,32186,13,4,0,30,0
28,540,04710,1,0,0,158,0,5,0,0,1,61,0,0,39576,61,5,1,158,1
28,540,04711,1,0,0,90,0,9,0,0,1,38,0,0,55781,38,9,1,90,1
28,540,04712,0,0,0,34,0,3,0,0,0,16,0,0,53013,16,3,0,34,0
28,540,04713,3,0,0,55,0,10,0,0,3,24,0,0,49291,24,10,3,55,3
28,540,04714,0,0,0,28,0,3,0,0,0,13,0,0,47639,13,3,0,28,0
28,540,04715,0,0,0,59,4,0,0,0,0,23,2,0,76519,25,0,0,63,0
28,540,04716,0,0,0,41,0,1,0,0,0,19,0,0,58344,19,1,0,41,0
28,540,04717,0,0,0,51,0,2,0,0,0,17,0,0,66041,17,2,0,51,0
28,540,04718,0,1,100,37,27,2,13,10,0,20,4,110,113812,24,15,10,64,1
28,540,04719,1,0,0,40,0,6,0,0,1,22,0,0,58704,22,6,1,40,1
28,540,04720,1,0,0,53,0,5,0,0,1,26,0,0,83876,26,5,1,53,1
28,540,04721,0,0,0,67,0,7,0,0,0,23,0,0,67179,23,7,0,67,0
28,540,04722,0,0,0,20,4,0,0,0,0,12,9,0,55428,21,0,0,24,0
28,541,04723,0,0,0,11,0,4,0,0,0,8,0,0,24728,8,4,0,11,0
28,541,04724,0,0,0,105,0,8,0,0,0,39,0,0,31619,39,8,0,105,0
28,541,04725,0,0,0,97,0,7,0,0,0,31,0,0,48376,31,7,0,97,0
28,541,04726,0,0,0,38,0,4,0,0,0,16,0,0,42853,16,4,0,38,0
28,541,04727,1,0,0,64,3,14,0,0,10,14,7,0,72117,21,14,10,67,1
28,541,04728,0,0,0,31,0,3,0,0,0,14,0,0,43067,14,3,0,31,0
28,541,04729,0,0,0,16,0,6,0,0,0,8,0,0,46802,8,6,0,16,0
28,541,04730,0,1,100,39,29,6,13,12,0,16,4,100,89048,20,19,12,68,1
28,541,04731,1,0,0,17,0,3,0,0,1,13,0,0,26245,13,3,1,17,1
28,541,04732,0,0,0,16,0,5,0,0,0,11,0,0,40688,11,5,0,16,0
28,541,04733,0,0,0,19,0,4,0,0,0,11,0,0,25424,11,4,0,19,0
28,541,04734,0,0,0,61,0,4,0,0,0,19,0,0,22882,19,4,0,61,0
28,541,04735,1,0,0,34,0,6,0,0,1,15,0,0,28392,15,6,1,34,1
28,541,04736,0,0,0,40,0,4,0,0,0,17,0,0,64580,17,4,0,40,0
28,541,04737,0,0,0,28,6,7,1,0,0,15,15,10,113872,30,8,0,34,0
28,541,04738,0,1,100,39,50,11,15,12,0,21,9,110,188191,30,26,12,89,1
28,541,04739,0,0,0,22,0,3,0,0,0,18,0,0,47879,18,3,0,22,0
28,541,04740,0,0,0,23,9,4,3,0,0,8,2,30,95394,10,7,0,32,0
28,541,04741,0,0,0,20,0,4,0,0,0,8,0,0,28125,8,4,0,20,0
28,541,04742,0,0,0,50,0,6,0,0,0,27,0,0,42587,27,6,0,50,0
28,541,04743,0,0,0,20,0,4,0,0,0,14,0,0,36998,14,4,0,20,0
28,541,04744,0,0,0,26,0,2,0,0,0,17,0,0,54897,17,2,0,26,0
28,541,04745,0,0,0,24,0,4,0,0,0,15,0,0,41955,15,4,0,24,0
28,541,04746,0,0,0,20,0,3,0,0,0,11,0,0,33395,11,3,0,20,0
28,541,04747,0,0,0,24,0,3,0,0,0,17,0,0,49041,17,3,0,24,0
28,541,04748,0,0,0,25,0,5,0,0,0,15,0,0,34794,15,5,0,25,0
28,541,04749,0,0,0,67,0,11,0,0,0,27,0,0,59652,27,11,0,67,0
28,541,04750,0,0,0,29,0,8,0,0,0,21,0,0,58444,21,8,0,29,0
28,541,04751,0,0,0,23,14,4,5,0,0,15,4,50,77043,19,9,0,37,0
28,541,04752,0,0,0,51,0,6,0,0,0,25,0,0,52841,25,6,0,51,0
28,541,04753,0,0,0,30,0,4,0,0,0,13,0,0,35342,13,4,0,30,0
28,541,04754,1,0,0,66,0,3,0,0,1,27,0,0,61502,27,3,1,66,1
28,541,04755,0,0,0,43,0,2,0,0,0,18,0,0,60020,18,2,0,43,0
28,541,04756,0,0,0,28,0,4,0,0,0,16,0,0,81138,16,4,0,28,0
28,541,04757,0,1,250,19,105,2,51,30,0,10,16,410,313504,26,53,30,124,1
28,541,04758,0,0,0,25,0,2,0,0,0,14,0,0,58485,14,2,0,25,0
28,541,04759,0,0,0,60,0,2,0,0,0,24,0,0,61325,24,2,0,60,0
28,541,04760,0,0,0,46,0,2,0,0,0,17,0,0,48909,17,2,0,46,0
28,541,04761,0,0,0,31,0,3,0,0,0,18,0,0,61321,18,3,0,31,0
28,541,04762,0,0,0,20,0,2,0,0,0,11,0,0,55750,11,2,0,20,0
28,541,04763,0,0,0,56,0,3,0,0,0,25,0,0,63828,25,3,0,56,0
28,541,04764,0,0,0,26,0,3,0,0,0,20,0,0,54320,20,3,0,26,0
28,541,04765,0,0,0,50,0,2,0,0,0,19,0,0,43909,19,2,0,50,0
28,541,04766,0,0,0,65,0,3,0,0,0,24,6,0,68548,30,3,0,65,0
28,541,04767,0,0,0,67,0,2,0,0,0,22,0,0,49851,22,2,0,67,0
28,541,04768,0,0,0,42,0,3,0,0,0,17,0,0,45078,17,3,0,42,0
28,542,04769,0,0,0,86,0,3,0,0,0,35,0,0,65616,35,3,0,86,0
28,542,04770,0,0,0,259,0,6,0,0,0,92,0,0,55714,92,6,0,259,0
28,542,04771,0,0,0,35,0,3,0,0,0,13,0,0,44157,13,3,0,35,0
28,542,04772,0,0,0,35,0,4,0,0,0,19,0,0,67093,19,4,0,35,0
28,542,04773,1,0,0,71,0,10,0,0,4,23,0,0,64634,23,10,4,71,1
28,542,04774,0,0,0,74,0,4,0,0,0,30,0,0,52628,30,4,0,74,0
28,542,04775,0,0,0,128,8,1,1,0,0,51,4,0,97495,55,2,0,136,0
28,542,04776,0,0,0,40,0,5,0,0,0,23,0,0,82699,23,5,0,40,0
28,542,04777,0,0,0,43,0,2,0,0,0,19,0,0,66632,19,2,0,43,0
28,542,04778,0,0,0,17,9,1,2,0,0,9,7,30,88965,16,3,0,26,0
28,542,04779,0,0,0,51,0,4,0,0,0,25,0,0,75974,25,4,0,51,0
28,542,04780,1,0,0,47,0,5,0,0,3,20,0,0,78908,20,5,3,47,1
28,542,04781,0,0,0,98,0,4,0,0,0,40,0,0,73212,40,4,0,98,0
28,542,04782,0,0,0,110,0,1,0,0,0,42,0,0,56277,42,1,0,110,0
28,542,04783,0,0,0,41,4,3,1,0,0,20,1,0,49997,21,4,0,45,0
28,542,04784,0,1,100,130,23,2,10,10,0,45,9,100,74972,54,12,10,153,1
28,542,04785,0,0,0,85,0,1,0,0,0,32,0,0,41133,32,1,0,85,0
28,542,04786,0,0,0,129,0,5,0,0,0,52,0,0,70493,52,5,0,129,0
28,542,04787,0,0,0,118,0,2,0,0,0,47,0,0,29107,47,2,0,118,0
28,542,04788,0,0,0,125,0,3,0,0,0,44,0,0,52243,44,3,0,125,0
28,542,04789,0,1,100,113,37,1,13,10,0,41,9,120,73993,50,14,10,150,1
28,542,04790,0,0,0,43,0,6,0,0,0,27,0,0,70561,27,6,0,43,0
28,542,04791,1,0,0,135,0,9,0,0,3,55,0,0,74718,55,9,3,135,1
28,542,04792,0,0,0,100,0,3,0,0,0,41,0,0,59549,41,3,0,100,0
28,542,04793,0,0,0,92,0,1,0,0,0,35,0,0,33254,35,1,0,92,0
28,542,04794,0,0,0,25,0,4,0,0,0,13,0,0,42140,13,4,0,25,0
28,542,04795,0,0,0,131,0,3,0,0,0,52,0,0,65419,52,3,0,131,0
28,542,04796,0,0,0,65,10,2,4,0,0,24,2,40,94039,26,6,0,75,0
28,542,04797,0,0,0,22,0,2,0,0,0,10,0,0,57519,10,2,0,22,0
28,542,04798,0,0,0,105,18,5,5,0,0,39,5,20,84093,44,10,0,123,0
28,542,04799,0,0,0,118,3,3,0,0,0,44,10,0,77321,54,3,0,121,0
28,542,04800,0,0,0,122,0,4,0,0,0,45,0,0,65622,45,4,0,122,0
28,542,04801,0,0,0,73,0,5,0,0,0,25,0,0,79604,25,5,0,73,0
28,542,04802,0,1,250,61,81,3,38,23,0,30,34,380,220332,64,41,23,142,1
28,542,04803,0,0,0,88,3,2,0,0,0,35,4,0,73890,39,2,0,91,0
28,542,04804,0,0,0,25,0,3,0,0,0,14,0,0,68621,14,3,0,25,0
28,542,04805,1,0,0,71,0,5,0,0,3,30,0,0,85863,30,5,3,71,1
28,542,04806,0,0,0,39,0,2,0,0,0,25,0,0,85270,25,2,0,39,0
28,543,04807,0,0,0,49,0,3,0,0,0,24,0,0,51842,24,3,0,49,0
28,543,04808,0,0,0,96,0,11,0,0,0,31,0,0,49377,31,11,0,96,0
28,543,04809,0,0,0,76,0,7,0,0,0,42,0,0,48252,42,7,0,76,0
28,543,04810,0,0,0,60,0,7,0,0,0,18,0,0,52360,18,7,0,60,0
28,543,04811,0,0,0,40,0,3,0,0,0,16,0,0,46734,16,3,0,40,0
28,543,04812,0,1,100,49,44,5,15,10,0,27,27,140,113596,54,20,10,93,1
28,543,04813,0,0,0,33,0,2,0,0,0,19,0,0,50434,19,2,0,33,0
28,543,04814,0,0,0,42,0,5,0,0,0,17,0,0,58182,17,5,0,42,0
28,543,04815,0,0,0,44,0,2,0,0,0,23,0,0,59764,23,2,0,44,0
28,543,04816,0,0,0,53,15,4,5,0,0,23,13,20,122964,36,9,0,68,0
28,543,04817,0,0,0,48,7,5,2,0,0,20,9,23,105265,29,7,0,55,0
28,543,04818,0,0,0,54,0,3,0,0,0,33,0,0,48233,33,3,0,54,0
28,543,04819,1,0,0,56,0,3,0,0,1,24,0,0,50464,24,3,1,56,1
28,543,04820,0,0,0,45,0,5,0,0,0,15,0,0,49384,15,5,0,45,0
28,543,04821,0,0,0,75,0,2,0,0,0,33,0,0,59688,33,2,0,75,0
28,543,04822,0,0,0,92,0,4,0,0,0,38,0,0,57237,38,4,0,92,0
28,543,04823,0,0,0,42,0,3,0,0,0,28,0,0,54447,28,3,0,42,0
28,543,04824,0,0,0,52,0,4,0,0,0,21,0,0,46756,21,4,0,52,0
28,543,04825,0,0,0,24,9,1,3,0,0,15,5,30,57529,20,4,0,33,0
28,543,04826,0,0,0,68,0,1,0,0,0,20,6,0,68289,26,1,0,68,0
28,543,04827,0,0,0,18,0,2,0,0,0,11,8,0,63408,19,2,0,18,0
28,543,04828,0,0,0,87,0,2,0,0,0,35,0,0,64658,35,2,0,87,0
28,543,04829,0,0,0,26,0,2,0,0,0,14,0,0,51125,14,2,0,26,0
28,543,04830,0,0,0,92,0,4,0,0,0,53,0,0,65554,53,4,0,92,0
28,543,04831,1,0,0,63,0,9,0,0,1,37,0,0,75877,37,9,1,63,1
28,543,04832,0,0,0,38,0,2,0,0,0,15,0,0,50580,15,2,0,38,0
28,543,04833,0,0,0,25,0,2,0,0,0,12,0,0,53029,12,2,0,25,0
28,543,04834,0,0,0,64,12,2,2,0,0,28,6,0,68579,34,4,0,76,0
28,543,04835,0,0,0,41,0,3,0,0,0,14,0,0,58066,14,3,0,41,0
28,543,04836,0,1,200,22,147,2,59,26,0,11,257,530,283550,268,61,26,169,1
28,543,04837,0,1,50,13,15,0,6,5,0,12,32,50,77031,44,6,5,28,1
28,543,04838,0,0,0,112,0,4,0,0,0,33,0,0,71955,33,4,0,112,0
28,543,04839,0,0,0,23,0,2,0,0,0,13,0,0,54382,13,2,0,23,0
28,543,04840,0,0,0,28,0,5,0,0,0,14,0,0,54858,14,5,0,28,0
28,544,04841,0,0,0,740,0,43,0,0,0,250,0,0,45445,250,43,0,740,0
28,544,04842,0,0,0,728,0,25,0,0,0,244,0,0,50934,244,25,0,728,0
28,544,04843,0,0,0,263,0,29,0,0,0,85,0,0,48854,85,29,0,263,0
28,544,04844,0,1,100,436,32,22,11,7,0,152,4,150,56134,156,33,7,468,1
28,544,04845,0,0,0,653,0,39,0,0,0,225,0,0,46778,225,39,0,653,0
28,544,04846,0,0,0,502,0,40,0,0,0,182,0,0,51453,182,40,0,502,0
28,544,04847,0,0,0,562,14,31,5,0,0,195,2,50,58318,197,36,0,576,0
28,544,04848,0,0,0,740,0,50,0,0,0,251,0,0,52422,251,50,0,740,0
28,544,04849,0,0,0,653,16,40,3,0,0,229,2,20,70647,231,43,0,669,0
28,544,04850,0,0,0,507,4,36,2,0,0,175,0,20,63029,175,38,0,511,0
28,544,04851,0,0,0,384,0,42,0,0,0,132,0,0,50240,132,42,0,384,0
28,544,04852,0,0,0,114,0,17,0,0,0,51,0,0,64563,51,17,0,114,0
28,544,04853,0,0,0,106,0,16,0,0,0,44,0,0,52852,44,16,0,106,0
28,544,04854,0,1,100,39,32,12,11,9,0,18,8,106,91612,26,23,9,71,1
28,544,04855,0,0,0,79,0,12,0,0,0,31,0,0,48328,31,12,0,79,0
28,544,04856,0,0,0,116,0,19,0,0,0,47,0,0,70749,47,19,0,116,0
28,544,04857,0,0,0,172,0,15,0,0,0,60,0,0,72006,60,15,0,172,0
28,544,04858,0,0,0,107,0,11,0,0,0,40,0,0,46643,40,11,0,107,0
28,544,04859,0,0,0,128,0,12,0,0,0,50,0,0,58287,50,12,0,128,0
28,544,04860,0,0,0,102,0,15,0,0,0,44,0,0,60498,44,15,0,102,0
28,544,04861,0,0,0,92,0,19,0,0,0,40,0,0,62713,40,19,0,92,0
28,544,04862,0,0,0,49,0,8,0,0,0,19,0,0,32380,19,8,0,49,0
28,544,04863,0,0,0,117,0,21,0,0,0,44,0,0,60789,44,21,0,117,0
28,544,04864,0,0,0,77,0,19,0,0,0,34,0,0,52079,34,19,0,77,0
28,544,04865,0,1,60,65,36,15,11,5,0,26,3,100,116349,29,26,5,101,1
28,544,04867,0,6,2184,0,1295,0,324,267,0,0,91,2804,977771,91,324,267,1295,6
28,544,04870,0,0,0,42,0,11,0,0,0,22,0,0,52605,22,11,0,42,0
28,544,04871,0,1,100,87,29,13,13,9,0,35,22,130,186937,57,26,9,116,1
28,544,04872,0,0,0,86,6,9,0,0,0,40,2,0,88493,42,9,0,92,0
28,544,04873,0,0,0,112,0,14,0,0,0,51,0,0,66177,51,14,0,112,0
28,544,04874,0,0,0,76,0,16,0,0,0,32,0,0,54510,32,16,0,76,0
28,544,04875,0,0,0,68,0,21,0,0,0,49,0,0,57568,49,21,0,68,0
28,544,04876,0,0,0,72,0,16,0,0,0,41,0,0,67262,41,16,0,72,0
28,544,04877,0,0,0,82,0,12,0,0,0,37,0,0,55520,37,12,0,82,0
28,544,04878,0,0,0,93,0,12,0,0,0,49,0,0,66577,49,12,0,93,0
28,544,04879,0,1,30,36,24,7,6,3,0,20,5,50,70553,25,13,3,60,1
28,544,04880,0,0,0,76,10,15,3,0,0,39,2,30,81079,41,18,0,86,0
28,544,04881,0,0,0,55,2,10,1,0,0,32,1,10,93093,33,11,0,57,0
28,544,04882,0,0,0,65,0,15,0,0,0,40,0,0,74101,40,15,0,65,0
28,544,04883,0,0,0,57,0,8,0,0,0,42,0,0,53903,42,8,0,57,0
28,545,04884,0,0,0,25,0,3,0,0,0,20,0,0,19232,20,3,0,25,0
28,545,04885,0,0,0,46,0,5,0,0,0,16,0,0,28178,16,5,0,46,0
28,545,04886,0,0,0,41,0,8,0,0,0,16,0,0,28140,16,8,0,41,0
28,545,04887,0,0,0,124,0,7,0,0,0,42,0,0,37106,42,7,0,124,0
28,545,04888,0,0,0,39,0,1,0,0,0,25,0,0,39524,25,1,0,39,0
28,545,04889,0,0,0,15,0,2,0,0,0,18,0,0,48512,18,2,0,15,0
28,545,04890,0,1,100,25,63,1,17,11,0,17,9,160,138079,26,18,11,88,1
28,545,04891,0,0,0,22,0,6,0,0,0,14,0,0,55236,14,6,0,22,0
28,545,04892,0,0,0,30,0,3,0,0,0,14,0,0,57005,14,3,0,30,0
28,545,04893,0,0,0,34,0,6,0,0,0,28,0,0,77965,28,6,0,34,0
28,545,04894,0,0,0,70,0,4,0,0,0,31,0,0,25824,31,4,0,70,0
28,545,04895,0,0,0,29,21,2,6,0,0,22,4,60,39314,26,8,0,50,0
28,545,04896,0,0,0,66,0,2,0,0,0,30,0,0,71665,30,2,0,66,0
28,545,04897,0,0,0,94,0,11,0,0,0,30,0,0,69596,30,11,0,94,0
28,545,04898,0,0,0,39,0,6,0,0,0,23,0,0,79605,23,6,0,39,0
28,545,04899,0,0,0,41,0,1,0,0,0,22,0,0,74379,22,1,0,41,0
28,545,04900,0,0,0,63,0,8,0,0,0,27,0,0,79036,27,8,0,63,0
28,545,04901,0,0,0,80,0,3,0,0,0,33,0,0,87592,33,3,0,80,0
28,545,04902,0,0,0,47,0,1,0,0,0,31,0,0,78926,31,1,0,47,0
28,545,04903,0,0,0,73,29,1,7,0,0,35,6,70,123399,41,8,0,102,0
28,545,04904,0,0,0,23,0,1,0,0,0,14,0,0,54278,14,1,0,23,0
28,545,04905,0,0,0,29,0,3,0,0,0,18,0,0,79553,18,3,0,29,0
28,545,04906,0,1,250,0,86,0,35,25,0,0,19,340,341831,19,35,25,86,1
28,545,04907,0,0,0,4,0,0,0,0,0,5,3,0,132471,8,0,0,4,0
28,545,04908,0,0,0,29,0,3,0,0,0,22,0,0,106085,22,3,0,29,0
28,545,04909,0,0,0,24,0,1,0,0,0,12,0,0,57106,12,1,0,24,0
28,545,04910,0,0,0,62,4,3,2,0,0,35,4,15,137979,39,5,0,66,0
28,545,04911,0,0,0,29,6,3,1,0,0,14,5,20,129282,19,4,0,35,0
28,545,04912,0,0,0,42,0,9,0,0,0,23,0,0,82788,23,9,0,42,0
28,545,04913,0,0,0,17,0,2,0,0,0,9,2,0,102485,11,2,0,17,0
28,545,04914,0,1,200,0,132,0,41,19,0,0,37,400,312538,37,41,19,132,1
28,545,04915,0,0,0,68,0,9,0,0,0,30,0,0,71459,30,9,0,68,0
28,545,04916,0,0,0,32,0,1,0,0,0,13,0,0,70277,13,1,0,32,0
28,545,04917,0,0,0,58,0,8,0,0,0,32,0,0,70859,32,8,0,58,0
28,545,04918,0,0,0,42,0,10,0,0,0,27,0,0,90499,27,10,0,42,0
28,545,04919,0,0,0,72,0,2,0,0,0,32,0,0,65580,32,2,0,72,0
28,545,04920,0,0,0,49,13,5,3,0,0,26,6,15,132679,32,8,0,62,0
28,545,04921,0,0,0,25,0,3,0,0,0,21,0,0,66456,21,3,0,25,0
28,545,04922,0,0,0,47,0,3,0,0,0,22,0,0,76398,22,3,0,47,0
28,545,04923,0,0,0,39,0,2,0,0,0,24,0,0,70903,24,2,0,39,0
28,545,04924,0,1,100,51,37,2,11,10,0,30,8,100,114527,38,13,10,88,1
28,545,04925,0,0,0,77,0,6,0,0,0,30,0,0,74025,30,6,0,77,0
28,545,04926,0,0,0,57,0,3,0,0,0,34,0,0,83360,34,3,0,57,0
28,545,04927,0,0,0,62,0,3,0,0,0,31,0,0,77859,31,3,0,62,0
28,545,04928,0,0,0,41,0,7,0,0,0,20,0,0,66809,20,7,0,41,0
28,545,04929,0,0,0,58,0,4,0,0,0,32,0,0,63013,32,4,0,58,0
28,545,04930,0,0,0,51,0,8,0,0,0,33,0,0,82799,33,8,0,51,0
28,545,04931,0,0,0,31,0,3,0,0,0,24,0,0,67434,24,3,0,31,0
28,545,04932,0,0,0,41,0,7,0,0,0,25,0,0,68586,25,7,0,41,0
28,545,04933,0,0,0,27,0,2,0,0,0,21,0,0,65161,21,2,0,27,0
28,545,04934,0,0,0,99,0,8,0,0,0,42,0,0,75306,42,8,0,99,0
28,545,04935,0,0,0,33,0,2,0,0,0,16,0,0,63134,16,2,0,33,0
28,545,04936,0,0,0,63,0,1,0,0,0,36,0,0,70639,36,1,0,63,0
28,545,04937,0,0,0,58,0,5,0,0,0,33,0,0,71433,33,5,0,58,0
28,545,04938,0,0,0,58,0,2,0,0,0,32,0,0,75847,32,2,0,58,0
28,545,04939,0,0,0,49,0,3,0,0,0,25,0,0,72560,25,3,0,49,0
28,545,04940,0,0,0,50,0,10,0,0,0,22,0,0,68242,22,10,0,50,0
28,545,04941,0,1,100,48,33,2,13,12,0,24,12,100,141693,36,15,12,81,1
28,545,04942,0,0,0,32,0,1,0,0,0,20,0,0,59931,20,1,0,32,0
28,545,04943,0,0,0,70,0,2,0,0,0,33,0,0,74819,33,2,0,70,0
28,546,04944,0,0,0,87,0,7,0,0,0,41,0,0,91372,41,7,0,87,0
28,546,04945,0,0,0,34,0,3,0,0,0,23,0,0,58360,23,3,0,34,0
28,546,04946,0,0,0,78,0,1,0,0,0,34,0,0,56160,34,1,0,78,0
28,546,04947,0,0,0,39,0,4,0,0,0,17,0,0,30031,17,4,0,39,0
28,546,04948,0,0,0,129,0,12,0,0,0,52,0,0,53031,52,12,0,129,0
28,546,04949,0,0,0,73,0,3,0,0,0,40,0,0,45352,40,3,0,73,0
28,546,04950,0,0,0,63,0,4,0,0,0,32,0,0,52785,32,4,0,63,0
28,546,04951,0,0,0,42,0,3,0,0,0,21,0,0,62597,21,3,0,42,0
28,546,04952,0,0,0,82,0,2,0,0,0,47,0,0,75694,47,2,0,82,0
28,546,04953,0,0,0,96,0,7,0,0,0,45,0,0,109772,45,7,0,96,0
28,546,04954,0,0,0,61,0,2,0,0,0,22,0,0,57588,22,2,0,61,0
28,546,04955,0,0,0,89,11,0,1,0,0,46,6,10,68989,52,1,0,100,0
28,546,04956,0,0,0,44,0,1,0,0,0,18,0,0,80388,18,1,0,44,0
28,546,04957,0,0,0,80,0,3,0,0,0,37,0,0,77971,37,3,0,80,0
28,546,04958,0,0,0,29,17,2,6,0,0,19,6,60,108445,25,8,0,46,0
28,546,04959,0,0,0,28,0,3,0,0,0,18,0,0,64774,18,3,0,28,0
28,546,04960,0,0,0,39,3,2,0,0,0,22,4,0,114245,26,2,0,42,0
28,546,04961,0,1,100,85,38,1,14,10,0,33,5,130,192162,38,15,10,123,1
28,546,04962,0,0,0,82,0,1,0,0,0,34,0,0,80722,34,1,0,82,0
28,546,04963,0,0,0,57,0,5,0,0,0,26,0,0,65216,26,5,0,57,0
28,546,04964,0,0,0,37,0,2,0,0,0,15,0,0,88810,15,2,0,37,0
28,546,04965,0,0,0,26,0,2,0,0,0,22,0,0,69141,22,2,0,26,0
28,546,04966,0,1,350,86,161,1,62,35,0,32,47,600,319405,79,63,35,247,1
28,546,04967,0,0,0,105,0,2,0,0,0,40,0,0,66695,40,2,0,105,0
28,546,04968,0,0,0,76,0,3,0,0,0,34,0,0,47623,34,3,0,76,0
28,546,04969,0,0,0,98,0,2,0,0,0,35,0,0,70458,35,2,0,98,0
28,546,04970,0,0,0,41,0,1,0,0,0,22,0,0,76489,22,1,0,41,0
28,546,04971,0,0,0,58,0,3,0,0,0,29,0,0,70194,29,3,0,58,0
28,546,04972,0,1,100,51,34,1,15,10,0,32,7,140,148529,39,16,10,85,1
28,546,04973,0,0,0,81,0,3,0,0,0,36,0,0,68881,36,3,0,81,0
28,546,04974,0,0,0,65,0,1,0,0,0,43,0,0,64963,43,1,0,65,0
28,546,04975,0,0,0,76,0,3,0,0,0,36,0,0,73889,36,3,0,76,0
28,546,04976,0,0,0,97,0,4,0,0,0,42,0,0,66049,42,4,0,97,0
28,546,04977,0,0,0,80,0,1,0,0,0,33,0,0,66119,33,1,0,80,0
28,546,04978,0,0,0,70,0,2,0,0,0,32,0,0,60153,32,2,0,70,0
28,546,04979,0,0,0,102,0,2,0,0,0,38,0,0,65831,38,2,0,102,0
28,546,04980,0,0,0,50,0,3,0,0,0,26,0,0,69317,26,3,0,50,0
28,546,04981,0,0,0,58,0,4,0,0,0,25,0,0,60711,25,4,0,58,0
28,546,04982,0,0,0,83,0,1,0,0,0,34,0,0,65706,34,1,0,83,0
28,546,04983,0,0,0,68,0,2,0,0,0,37,0,0,64912,37,2,0,68,0
28,546,04984,0,0,42.30769348144531,45,38,2,9.153846740722656,4.230769157409668,0,26,5,166.9230804443359,226497,31,11.153847,4.2307692,83,0
28,546,04985,0,0,0,70,0,2,0,0,0,28,0,0,68118,28,2,0,70,0
28,546,04986,0,0,0,51,0,1,0,0,0,23,0,0,72255,23,1,0,51,0
28,546,04987,0,0,0,102,15,1,4,0,0,38,6,50,138741,44,5,0,117,0
28,546,04988,0,0,0,89,24,2,7,0,0,29,5,80,129717,34,9,0,113,0
28,546,04989,0,0,0,96,0,3,0,0,0,37,0,0,71890,37,3,0,96,0
28,547,04990,0,0,0,64,0,2,0,0,0,27,0,0,61749,27,2,0,64,0
28,547,04991,0,1,30,65,26,2,9,3,0,24,6,70,126259,30,11,3,91,1
28,547,04992,0,0,0,37,0,2,0,0,0,19,0,0,51811,19,2,0,37,0
28,547,04993,0,0,0,82,0,6,0,0,0,37,0,0,92291,37,6,0,82,0
28,547,04994,0,0,0,79,0,5,0,0,0,28,0,0,49089,28,5,0,79,0
28,547,04995,0,0,0,38,0,5,0,0,0,18,0,0,66947,18,5,0,38,0
28,547,04996,0,0,0,32,0,2,0,0,0,20,0,0,71544,20,2,0,32,0
28,547,04997,0,0,0,27,13,2,4,0,0,15,7,50,76731,22,6,0,40,0
28,547,04998,0,0,0,20,0,2,0,0,0,12,0,0,48463,12,2,0,20,0
28,547,04999,0,0,0,26,0,2,0,0,0,11,0,0,46226,11,2,0,26,0
28,547,05000,0,0,0,54,0,9,0,0,0,23,0,0,59798,23,9,0,54,0
28,547,05001,0,0,0,26,0,3,0,0,0,13,0,0,53493,13,3,0,26,0
28,547,05002,0,0,0,49,0,4,0,0,0,18,0,0,57197,18,4,0,49,0
28,547,05003,0,1,100,51,18,2,12,9,0,20,5,130,129553,25,14,9,69,1
28,547,05004,0,0,0,61,0,4,0,0,0,27,0,0,84881,27,4,0,61,0
28,547,05005,0,0,0,50,0,6,0,0,0,25,0,0,62098,25,6,0,50,0
28,547,05006,0,0,0,72,0,6,0,0,0,94,0,0,57693,94,6,0,72,0
28,547,05007,0,0,0,61,0,9,0,0,0,26,0,0,71075,26,9,0,61,0
28,547,05008,0,0,0,46,0,2,0,0,0,19,0,0,59943,19,2,0,46,0
28,547,05009,0,1,30,15,30,0,5,2,0,11,6,70,103559,17,5,2,45,1
28,547,05010,0,2,400,0,163,0,58,40,0,0,156,570,1021806,156,58,40,163,2
28,547,05011,0,0,0,12,4,0,0,0,0,6,4,0,55092,10,0,0,16,0
28,547,05012,0,0,0,71,0,7,0,0,0,30,0,0,87027,30,7,0,71,0
28,547,05013,0,0,0,68,0,4,0,0,0,33,0,0,54323,33,4,0,68,0
28,547,05014,0,0,0,74,0,4,0,0,0,24,0,0,36924,24,4,0,74,0
28,547,05015,0,0,0,68,0,0,0,0,0,28,0,0,48627,28,0,0,68,0
28,547,05016,0,0,0,61,0,5,0,0,0,33,0,0,77654,33,5,0,61,0
28,547,05017,0,0,0,38,0,3,0,0,0,23,0,0,70729,23,3,0,38,0
28,547,05018,0,0,0,48,0,4,0,0,0,19,0,0,48892,19,4,0,48,0
28,547,05019,0,0,0,57,0,3,0,0,0,24,0,0,46370,24,3,0,57,0
28,547,05020,0,0,0,83,0,4,0,0,0,36,0,0,64377,36,4,0,83,0
28,547,05021,0,1,100,79,57,2,17,10,0,30,27,140,161453,57,19,10,136,1
28,547,05022,0,0,0,52,0,4,0,0,0,20,0,0,31348,20,4,0,52,0
28,547,05023,0,0,0,44,0,0,0,0,0,18,4,0,69562,22,0,0,44,0
28,547,05024,0,0,0,8,8,0,0,0,0,5,5,0,145095,10,0,0,16,0
28,547,05025,0,0,0,46,0,2,0,0,0,16,0,0,38604,16,2,0,46,0
28,547,05026,0,0,0,26,0,4,0,0,0,12,0,0,53913,12,4,0,26,0
28,547,05027,0,0,0,49,0,7,0,0,0,24,0,0,76703,24,7,0,49,0
28,547,05028,0,0,0,31,0,3,0,0,0,17,0,0,54634,17,3,0,31,0
28,547,05029,0,0,0,77,0,4,0,0,0,26,0,0,51753,26,4,0,77,0
28,547,05030,0,0,0,38,3,2,0,0,0,14,3,0,65657,17,2,0,41,0
28,547,05031,0,0,0,71,0,6,0,0,0,26,0,0,49228,26,6,0,71,0
28,547,05032,0,0,0,24,0,3,0,0,0,18,0,0,52974,18,3,0,24,0
28,547,05033,0,0,0,40,0,5,0,0,0,15,0,0,40098,15,5,0,40,0
28,547,05034,0,1,350,23,137,0,41,25,0,94,26,520,238962,120,41,25,160,1
28,547,05035,0,0,0,36,0,5,0,0,0,23,0,0,53540,23,5,0,36,0
28,547,05036,0,0,0,30,0,4,0,0,0,12,0,0,35967,12,4,0,30,0
28,547,05037,0,0,0,27,0,5,0,0,0,10,0,0,40986,10,5,0,27,0
28,547,05038,0,0,0,38,0,7,0,0,0,14,0,0,47899,14,7,0,38,0
28,547,05039,0,0,0,30,0,2,0,0,0,11,0,0,45281,11,2,0,30,0
28,548,05040,0,3,50,21,48,3,14,7,0,13,18,120,113048,31,17,7,69,3
28,548,05041,0,0,0,21,0,2,0,0,0,12,0,0,49054,12,2,0,21,0
28,548,05042,0,0,0,19,0,2,0,0,0,11,0,0,49059,11,2,0,19,0
28,548,05043,0,0,0,14,0,1,0,0,0,13,0,0,49827,13,1,0,14,0
28,548,05044,0,0,0,29,0,4,0,0,0,18,0,0,66070,18,4,0,29,0
28,548,05045,0,0,0,18,0,2,0,0,0,26,0,0,75233,26,2,0,18,0
28,548,05046,0,0,0,19,0,3,0,0,0,13,0,0,52367,13,3,0,19,0
28,548,05047,0,0,0,11,11,1,2,0,0,10,8,0,122319,18,3,0,22,0
28,548,05048,0,0,0,21,0,2,0,0,0,15,0,0,52469,15,2,0,21,0
28,548,05049,0,0,0,29,0,2,0,0,0,15,0,0,38455,15,2,0,29,0
28,548,05050,0,0,0,23,0,1,0,0,0,20,0,0,58447,20,1,0,23,0
28,548,05051,0,0,0,35,0,2,0,0,0,17,0,0,56308,17,2,0,35,0
28,548,05052,0,0,0,36,0,8,0,0,0,21,0,0,66277,21,8,0,36,0
28,548,05053,0,0,0,22,0,4,0,0,0,13,0,0,54081,13,4,0,22,0
28,548,05054,0,0,0,8,16,0,2,0,0,6,3,0,99428,9,2,0,24,0
28,548,05055,0,1,20,25,12,3,4,2,0,16,13,40,160303,29,7,2,37,1
28,548,05056,0,0,0,22,0,4,0,0,0,13,0,0,67962,13,4,0,22,0
28,548,05057,0,0,0,39,0,6,0,0,0,20,0,0,50030,20,6,0,39,0
28,548,05058,0,1,20,31,45,3,11,2,0,20,13,110,130608,33,14,2,76,1
28,548,05059,0,0,0,22,0,4,0,0,0,17,0,0,45213,17,4,0,22,0
28,548,05060,0,0,0,22,0,3,0,0,0,15,0,0,63349,15,3,0,22,0
28,548,05061,0,0,0,19,0,1,0,0,0,15,0,0,58086,15,1,0,19,0
28,548,05062,0,0,0,57,16,2,5,0,0,21,11,50,112498,32,7,0,73,0
28,548,05063,0,0,0,43,0,3,0,0,0,22,0,0,52853,22,3,0,43,0
28,548,05064,0,0,0,16,0,1,0,0,0,8,0,0,37994,8,1,0,16,0
28,548,05065,0,0,0,52,0,7,0,0,0,18,0,0,46681,18,7,0,52,0
28,548,05066,0,0,0,22,0,3,0,0,0,16,0,0,62060,16,3,0,22,0
28,548,05067,0,1,120,21,50,2,19,14,0,16,16,160,211948,32,21,14,71,1
28,548,05068,0,0,0,19,0,3,0,0,0,15,0,0,42509,15,3,0,19,0
28,548,05069,0,0,0,26,0,2,0,0,0,9,0,0,68978,9,2,0,26,0
28,548,05070,0,0,120.5,36,14,4,16,9.071428298950195,0,15,77,201.2142639160156,153629,92,20,9.0714283,50,0
28,548,05071,0,0,0,22,0,2,0,0,0,20,0,0,56321,20,2,0,22,0
28,548,05072,0,0,0,28,0,2,0,0,0,19,0,0,63449,19,2,0,28,0
28,548,05073,0,0,0,30,0,5,0,0,0,23,0,0,60144,23,5,0,30,0
28,548,05074,0,2,1177,21,238,2,116,71,0,16,110,1607,779289,126,118,71,259,2
28,548,05075,0,0,0,28,0,1,0,0,0,23,0,0,73689,23,1,0,28,0
28,548,05076,0,0,0,26,0,3,0,0,0,20,0,0,62655,20,3,0,26,0
28,548,05077,0,0,0,35,0,6,0,0,0,19,0,0,56662,19,6,0,35,0
28,548,05078,0,1,200,28,101,6,29,21,0,17,12,280,240031,29,35,21,129,1
28,548,05079,0,0,0,53,0,6,0,0,0,18,0,0,72141,18,6,0,53,0
28,548,05080,0,0,0,29,0,4,0,0,0,16,0,0,45773,16,4,0,29,0
28,548,05081,0,0,0,28,0,7,0,0,0,14,0,0,49390,14,7,0,28,0
28,548,05082,0,0,0,29,0,5,0,0,0,16,0,0,41980,16,5,0,29,0
28,548,05083,0,0,0,21,0,2,0,0,0,11,0,0,40681,11,2,0,21,0
28,548,05084,0,0,0,41,2,8,0,0,0,22,6,0,123417,28,8,0,43,0
28,548,05085,0,0,0,39,0,6,0,0,0,21,0,0,45778,21,6,0,39,0
28,548,05086,0,0,0,48,0,6,0,0,0,29,0,0,44713,29,6,0,48,0
28,548,05087,0,0,0,29,0,7,0,0,0,15,0,0,43586,15,7,0,29,0
28,548,05088,0,0,0,18,0,2,0,0,0,13,0,0,55323,13,2,0,18,0
28,548,05089,0,0,0,26,0,3,0,0,0,11,0,0,50252,11,3,0,26,0
28,548,05090,0,0,0,31,0,5,0,0,0,18,0,0,60385,18,5,0,31,0
28,548,05091,0,0,0,29,0,7,0,0,0,13,0,0,38609,13,7,0,29,0
28,548,05092,0,0,0,17,0,3,0,0,0,16,0,0,50320,16,3,0,17,0
28,548,05093,0,1,100,26,54,3,14,10,0,17,6,140,143825,23,17,10,80,1
28,548,05094,0,0,0,42,0,11,0,0,0,18,0,0,59973,18,11,0,42,0
28,548,05095,0,0,0,48,0,10,0,0,0,21,0,0,50262,21,10,0,48,0
28,548,05096,0,0,0,15,16,2,4,0,0,15,9,30,111989,24,6,0,31,0
28,549,05097,0,0,0,32,0,7,0,0,0,21,0,0,64011,21,7,0,32,0
28,549,05098,0,0,0,19,0,2,0,0,0,9,0,0,53279,9,2,0,19,0
28,549,05099,0,0,0,17,0,3,0,0,0,7,0,0,62627,7,3,0,17,0
28,549,05100,0,0,0,31,0,5,0,0,0,17,0,0,44105,17,5,0,31,0
28,549,05101,0,0,0,23,0,3,0,0,0,10,0,0,42262,10,3,0,23,0
28,549,05102,0,0,0,32,0,1,0,0,0,14,0,0,48148,14,1,0,32,0
28,549,05103,0,0,0,34,0,2,0,0,0,14,0,0,40801,14,2,0,34,0
28,549,05104,0,0,0,23,0,2,0,0,0,10,0,0,59528,10,2,0,23,0
28,549,05105,0,0,0,17,0,0,0,0,0,9,0,0,53269,9,0,0,17,0
28,549,05106,0,0,0,42,0,5,0,0,0,15,0,0,73862,15,5,0,42,0
28,549,05107,0,0,0,18,0,2,0,0,0,7,0,0,28373,7,2,0,18,0
28,549,05108,0,0,0,35,0,6,0,0,0,13,0,0,54668,13,6,0,35,0
28,549,05109,0,0,0,33,0,5,0,0,0,11,0,0,38916,11,5,0,33,0
28,549,05110,0,0,0,26,0,1,0,0,0,13,0,0,49546,13,1,0,26,0
28,549,05111,0,0,0,33,0,1,0,0,0,17,0,0,45186,17,1,0,33,0
28,549,05112,0,0,0,57,0,5,0,0,0,20,0,0,89769,20,5,0,57,0
28,549,05113,0,0,0,54,0,4,0,0,0,20,0,0,56783,20,4,0,54,0
28,549,05114,0,0,0,31,0,4,0,0,0,14,0,0,86702,14,4,0,31,0
28,549,05115,0,1,100,56,25,3,11,9,0,22,8,100,122984,30,14,9,81,1
28,549,05116,0,0,0,37,0,1,0,0,0,13,0,0,36169,13,1,0,37,0
28,549,05117,0,0,0,35,7,1,3,0,0,14,5,30,48698,19,4,0,42,0
28,549,05118,0,0,0,72,0,2,0,0,0,25,0,0,34640,25,2,0,72,0
28,549,05119,0,0,0,32,0,3,0,0,0,16,0,0,49211,16,3,0,32,0
28,549,05120,0,0,0,17,5,1,1,0,0,12,4,0,67017,16,2,0,22,0
28,549,05121,0,0,0,21,0,1,0,0,0,11,0,0,48400,11,1,0,21,0
28,549,05122,0,0,0,32,0,3,0,0,0,21,0,0,48273,21,3,0,32,0
28,549,05123,0,1,100,16,37,1,14,9,0,19,10,140,172826,29,15,9,53,1
28,549,05124,0,0,0,13,3,2,2,0,0,9,1,0,71655,10,4,0,16,0
28,549,05125,0,0,0,14,0,2,0,0,0,8,0,0,42468,8,2,0,14,0
28,549,05126,0,0,0,54,0,6,0,0,0,24,0,0,67733,24,6,0,54,0
28,549,05127,0,0,0,33,0,2,0,0,0,16,0,0,52353,16,2,0,33,0
28,549,05128,0,0,0,75,0,5,0,0,0,31,0,0,79343,31,5,0,75,0
28,549,05129,0,0,0,30,0,3,0,0,0,17,0,0,38848,17,3,0,30,0
28,549,05130,0,0,0,12,0,1,0,0,0,8,0,0,30937,8,1,0,12,0
28,549,05131,0,0,0,56,0,5,0,0,0,24,0,0,51062,24,5,0,56,0
28,549,05132,0,0,0,39,0,2,0,0,0,13,0,0,35080,13,2,0,39,0
28,549,05133,0,1,50,46,30,2,9,2,0,18,7,120,86133,25,11,2,76,1
28,549,05134,0,0,0,51,0,2,0,0,0,23,0,0,40517,23,2,0,51,0
28,549,05135,0,0,0,22,0,3,0,0,0,9,0,0,35951,9,3,0,22,0
28,549,05136,0,0,0,18,16,1,7,0,0,12,8,70,92459,20,8,0,34,0
28,549,05137,0,0,0,55,0,5,0,0,0,19,0,0,43004,19,5,0,55,0
28,549,05138,0,0,0,21,0,4,0,0,0,17,0,0,62588,17,4,0,21,0
28,549,05139,0,1,500,19,154,0,72,51,0,14,156,680,253122,170,72,51,173,1
28,549,05140,0,0,0,20,0,2,0,0,0,10,0,0,50006,10,2,0,20,0
28,549,05141,0,0,0,23,0,2,0,0,0,16,0,0,62618,16,2,0,23,0
28,549,05142,0,0,0,23,0,3,0,0,0,12,0,0,42866,12,3,0,23,0
28,549,05143,0,0,0,13,0,1,0,0,0,9,0,0,43016,9,1,0,13,0
28,549,05144,0,0,0,15,0,2,0,0,0,10,0,0,36964,10,2,0,15,0
28,549,05145,0,0,0,21,0,4,0,0,0,11,0,0,44913,11,4,0,21,0
28,549,05146,0,0,0,15,6,0,2,0,0,8,6,0,63001,14,2,0,21,0
28,549,05147,0,0,0,19,0,3,0,0,0,10,0,0,39855,10,3,0,19,0
28,549,05148,0,1,100,15,21,1,9,8,0,8,3,110,98769,11,10,8,36,1
28,549,05149,0,0,0,13,5,2,1,0,0,8,1,10,65784,9,3,0,18,0
28,549,05150,0,0,0,16,0,2,0,0,0,11,0,0,38094,11,2,0,16,0
28,549,05151,0,0,0,14,0,2,0,0,0,11,0,0,46883,11,2,0,14,0
28,549,05152,0,0,0,39,0,6,0,0,0,16,0,0,53918,16,6,0,39,0
28,550,05153,0,0,0,77,0,2,0,0,0,29,0,0,22785,29,2,0,77,0
28,550,05154,0,0,0,72,0,5,0,0,0,31,0,0,36378,31,5,0,72,0
28,550,05155,0,0,0,106,0,2,0,0,0,38,0,0,32828,38,2,0,106,0
28,550,05156,0,0,0,86,0,2,0,0,0,32,0,0,39007,32,2,0,86,0
28,550,05157,0,0,0,66,0,3,0,0,0,24,0,0,45853,24,3,0,66,0
28,550,05158,0,1,100,72,38,2,15,10,0,29,5,150,150333,34,17,10,110,1
28,550,05159,0,0,0,58,0,2,0,0,0,26,0,0,49088,26,2,0,58,0
28,550,05160,0,0,0,78,0,1,0,0,0,32,0,0,43954,32,1,0,78,0
28,550,05161,0,0,0,72,0,5,0,0,0,34,0,0,41392,34,5,0,72,0
28,550,05162,0,0,0,57,0,2,0,0,0,24,0,0,27291,24,2,0,57,0
28,550,05163,0,0,0,92,0,2,0,0,0,35,0,0,44698,35,2,0,92,0
28,550,05164,0,0,0,74,0,5,0,0,0,31,0,0,61217,31,5,0,74,0
28,550,05165,0,0,0,95,0,2,0,0,0,36,0,0,33620,36,2,0,95,0
28,550,05166,0,0,0,86,0,2,0,0,0,32,0,0,37438,32,2,0,86,0
28,550,05167,0,0,0,74,0,5,0,0,0,35,0,0,52602,35,5,0,74,0
28,550,05168,0,0,0,28,0,3,0,0,0,29,0,0,47489,29,3,0,28,0
28,550,05169,0,0,0,72,0,3,0,0,0,50,0,0,48820,50,3,0,72,0
28,550,05170,0,0,0,73,0,7,0,0,0,41,0,0,78463,41,7,0,73,0
28,550,05171,0,0,0,62,0,2,0,0,0,31,0,0,44734,31,2,0,62,0
28,550,05172,0,0,0,67,0,2,0,0,0,30,0,0,34630,30,2,0,67,0
28,550,05173,0,0,0,77,0,3,0,0,0,33,0,0,42950,33,3,0,77,0
28,550,05174,0,0,0,79,0,3,0,0,0,30,0,0,43242,30,3,0,79,0
28,550,05175,0,0,0,128,0,6,0,0,0,52,0,0,45747,52,6,0,128,0
28,550,05176,0,0,0,139,0,7,0,0,0,57,0,0,68148,57,7,0,139,0
28,550,05177,0,1,600,109,285,2,100,68,0,40,129,960,631791,169,102,68,394,1
28,550,05178,0,0,0,58,0,8,0,0,0,29,0,0,76598,29,8,0,58,0
28,550,05179,0,0,0,84,0,9,0,0,0,56,0,0,58543,56,9,0,84,0
28,550,05180,0,0,0,91,0,3,0,0,0,44,0,0,50490,44,3,0,91,0
28,550,05181,0,0,0,73,0,1,0,0,0,30,0,0,58003,30,1,0,73,0
28,550,05182,0,0,0,102,0,6,0,0,0,39,0,0,61275,39,6,0,102,0
28,550,05183,0,0,0,70,0,4,0,0,0,32,0,0,39074,32,4,0,70,0
28,550,05184,0,1,100,84,28,2,13,9,0,34,26,120,116330,60,15,9,112,1
28,550,05185,0,0,0,28,0,2,0,0,0,22,0,0,43704,22,2,0,28,0
28,550,05186,0,0,0,151,0,2,0,0,0,53,0,0,40427,53,2,0,151,0
28,550,05187,0,0,0,171,9,1,2,0,0,62,11,15,79544,73,3,0,180,0
28,550,05188,0,0,0,161,0,3,0,0,0,56,0,0,33864,56,3,0,161,0
28,550,05189,0,0,0,64,0,6,0,0,0,23,0,0,34487,23,6,0,64,0
28,550,05190,0,0,0,106,0,3,0,0,0,51,0,0,52451,51,3,0,106,0
28,550,05191,0,0,0,67,0,8,0,0,0,26,0,0,55226,26,8,0,67,0
28,550,05192,0,0,0,115,0,5,0,0,0,41,0,0,37667,41,5,0,115,0
28,550,05193,0,0,0,118,0,4,0,0,0,44,0,0,40224,44,4,0,118,0
28,550,05194,0,0,0,94,12,0,2,0,0,35,10,20,79636,45,2,0,106,0
28,550,05195,0,0,0,105,0,4,0,0,0,37,0,0,34454,37,4,0,105,0
28,550,05196,0,0,0,13,0,3,0,0,0,10,0,0,35946,10,3,0,13,0
28,550,05197,0,0,0,97,3,1,0,0,0,35,2,0,83760,37,1,0,100,0
28,550,05198,0,0,0,79,4,1,0,0,0,41,1,0,46468,42,1,0,83,0
28,551,05199,0,0,0,54,0,3,0,0,0,45,0,0,42093,45,3,0,54,0
28,551,05200,0,0,0,14,0,2,0,0,0,7,0,0,41925,7,2,0,14,0
28,551,05201,0,0,0,45,0,3,0,0,0,20,0,0,32541,20,3,0,45,0
28,551,05202,0,0,0,69,0,2,0,0,0,41,0,0,32829,41,2,0,69,0
28,551,05203,0,0,0,58,0,2,0,0,0,32,0,0,51872,32,2,0,58,0
28,551,05204,0,0,0,35,0,6,0,0,0,22,0,0,81019,22,6,0,35,0
28,551,05205,0,0,0,11,0,1,0,0,0,11,0,0,37278,11,1,0,11,0
28,551,05206,0,0,0,14,0,1,0,0,0,12,0,0,30532,12,1,0,14,0
28,551,05207,0,0,0,9,0,1,0,0,0,7,0,0,31296,7,1,0,9,0
28,551,05208,0,0,0,44,0,9,0,0,0,25,0,0,57890,25,9,0,44,0
28,551,05209,0,0,0,12,0,2,0,0,0,5,0,0,20471,5,2,0,12,0
28,551,05210,0,1,20,11,10,0,3,2,0,8,7,30,50136,15,3,2,21,1
28,551,05211,0,0,0,15,0,3,0,0,0,8,0,0,17661,8,3,0,15,0
28,551,05212,0,0,0,25,0,2,0,0,0,16,0,0,50320,16,2,0,25,0
28,551,05213,0,0,0,25,0,1,0,0,0,23,0,0,41379,23,1,0,25,0
28,551,05214,0,1,100,33,58,2,16,10,0,20,18,165,258879,38,18,10,91,1
28,551,05215,0,0,0,46,15,0,5,0,0,23,4,60,78326,27,5,0,61,0
28,551,05216,0,0,0,4,0,0,0,0,0,4,2,0,34366,6,0,0,4,0
28,551,05217,0,0,0,61,0,6,0,0,0,31,0,0,32819,31,6,0,61,0
28,551,05218,0,0,0,11,0,1,0,0,0,13,0,0,29886,13,1,0,11,0
28,551,05219,0,1,100,10,25,1,10,10,0,7,2,100,78884,9,11,10,35,1
28,551,05220,0,0,0,44,0,2,0,0,0,20,0,0,29160,20,2,0,44,0
28,551,05221,0,0,0,45,0,2,0,0,0,18,0,0,23964,18,2,0,45,0
28,551,05222,0,0,0,22,0,6,0,0,0,11,0,0,32910,11,6,0,22,0
28,551,05223,0,1,10,7,11,2,2,1,0,12,2,20,77072,14,4,1,18,1
28,551,05224,0,0,0,45,0,11,0,0,0,20,0,0,52168,20,11,0,45,0
28,551,05225,0,0,0,24,0,1,0,0,0,13,0,0,28873,13,1,0,24,0
28,551,05226,0,0,0,27,0,5,0,0,0,15,0,0,34414,15,5,0,27,0
28,551,05227,0,0,0,14,0,2,0,0,0,7,0,0,24318,7,2,0,14,0
28,551,05228,0,0,0,21,0,4,0,0,0,13,0,0,33100,13,4,0,21,0
28,551,05229,0,0,0,35,0,7,0,0,0,19,0,0,37452,19,7,0,35,0
28,551,05230,0,1,350,0,159,0,64,35,0,0,29,690,318916,29,64,35,159,1
28,551,05231,0,0,0,17,0,2,0,0,0,11,0,0,31347,11,2,0,17,0
28,551,05232,0,0,0,29,0,4,0,0,0,33,0,0,44008,33,4,0,29,0
28,551,05233,0,0,0,59,0,7,0,0,0,23,0,0,61344,23,7,0,59,0
28,551,05234,0,0,0,73,0,4,0,0,0,26,0,0,31258,26,4,0,73,0
28,551,05235,0,0,0,52,0,8,0,0,0,30,0,0,50833,30,8,0,52,0
28,551,05236,0,0,0,47,0,5,0,0,0,21,0,0,34515,21,5,0,47,0
28,551,05237,0,0,0,30,0,5,0,0,0,11,0,0,37006,11,5,0,30,0
28,551,05238,0,0,0,21,0,4,0,0,0,33,0,0,57140,33,4,0,21,0
28,551,05239,0,1,50,16,26,2,10,5,0,13,14,120,124565,27,12,5,42,1
28,551,05240,0,0,0,58,0,6,0,0,0,22,0,0,35246,22,6,0,58,0
28,551,05241,0,0,0,49,0,2,0,0,0,29,0,0,35220,29,2,0,49,0
28,551,05242,0,0,0,43,0,2,0,0,0,20,0,0,35530,20,2,0,43,0
28,551,05243,0,0,0,23,0,4,0,0,0,11,0,0,39902,11,4,0,23,0
28,551,05244,0,0,0,26,0,2,0,0,0,21,0,0,42360,21,2,0,26,0
28,551,05245,0,0,0,15,0,2,0,0,0,9,0,0,42076,9,2,0,15,0
28,551,05246,0,0,0,28,20,2,7,0,0,16,20,70,103871,36,9,0,48,0
28,551,05247,0,0,0,25,0,2,0,0,0,18,0,0,39434,18,2,0,25,0
28,551,05248,0,0,0,27,0,4,0,0,0,17,0,0,53275,17,4,0,27,0
28,551,05249,0,0,0,30,0,8,0,0,0,28,0,0,90799,28,8,0,30,0
28,552,05250,0,0,0,21,0,1,0,0,0,18,0,0,61294,18,1,0,21,0
28,552,05251,0,0,0,17,0,2,0,0,0,16,0,0,69275,16,2,0,17,0
28,552,05252,0,0,0,26,0,2,0,0,0,21,0,0,78121,21,2,0,26,0
28,552,05253,0,0,0,24,0,3,0,0,0,11,0,0,56966,11,3,0,24,0
28,552,05254,0,0,0,19,9,2,4,0,0,11,5,50,169344,16,6,0,28,0
28,552,05255,0,0,0,12,0,2,0,0,0,8,0,0,61215,8,2,0,12,0
28,552,05256,0,0,0,30,0,2,0,0,0,9,0,0,57167,9,2,0,30,0
28,552,05257,0,0,0,31,0,4,0,0,0,10,0,0,46266,10,4,0,31,0
28,552,05258,0,1,1200,22,558,3,153,112,0,14,56,1690,196268,70,156,112,580,1
28,552,05259,0,0,0,27,0,0,0,0,0,14,0,0,93962,14,0,0,27,0
28,552,05260,0,0,0,31,0,6,0,0,0,14,0,0,83748,14,6,0,31,0
28,552,05261,0,0,0,30,0,3,0,0,0,12,0,0,35267,12,3,0,30,0
28,552,05262,0,0,0,20,0,4,0,0,0,9,0,0,37666,9,4,0,20,0
28,552,05263,0,0,0,34,0,3,0,0,0,14,0,0,30362,14,3,0,34,0
28,552,05264,0,1,40,2,16,1,6,4,0,2,3,50,31805,5,7,4,18,1
28,552,05265,0,0,0,43,0,11,0,0,0,19,0,0,76028,19,11,0,43,0
28,552,05266,0,0,0,30,0,5,0,0,0,13,0,0,40358,13,5,0,30,0
28,552,05267,0,0,0,27,0,3,0,0,0,11,0,0,41652,11,3,0,27,0
28,552,05268,0,0,0,41,0,7,0,0,0,14,0,0,58437,14,7,0,41,0
28,552,05269,0,0,0,38,0,7,0,0,0,16,0,0,74594,16,7,0,38,0
28,552,05270,0,0,0,22,0,2,0,0,0,12,0,0,73873,12,2,0,22,0
28,552,05271,0,1,100,34,65,2,22,10,0,19,13,200,269286,32,24,10,99,1
28,552,05272,0,0,0,17,0,2,0,0,0,7,0,0,50592,7,2,0,17,0
28,552,05273,0,0,0,28,0,4,0,0,0,11,0,0,41123,11,4,0,28,0
28,552,05274,0,0,0,32,0,6,0,0,0,15,0,0,55834,15,6,0,32,0
28,552,05275,0,0,0,35,0,7,0,0,0,25,0,0,65088,25,7,0,35,0
28,552,05276,0,0,0,28,0,2,0,0,0,11,0,0,71237,11,2,0,28,0
28,552,05277,0,0,0,26,0,2,0,0,0,10,0,0,47103,10,2,0,26,0
28,552,05278,0,0,0,34,0,5,0,0,0,13,0,0,63120,13,5,0,34,0
28,552,05279,0,0,0,22,2,3,0,0,0,9,8,0,88726,17,3,0,24,0
28,552,05280,0,0,0,40,0,6,0,0,0,14,0,0,51426,14,6,0,40,0
28,552,05281,0,0,0,31,0,1,0,0,0,14,0,0,42810,14,1,0,31,0
28,552,05282,0,0,0,42,0,12,0,0,0,15,0,0,47850,15,12,0,42,0
28,552,05283,0,0,0,27,0,2,0,0,0,18,0,0,48592,18,2,0,27,0
28,552,05284,0,1,200,28,34,1,13,10,0,12,43,240,269368,55,14,10,62,1
28,552,05285,0,0,0,22,0,4,0,0,0,17,0,0,38487,17,4,0,22,0
28,552,05286,0,0,0,14,0,2,0,0,0,16,0,0,58014,16,2,0,14,0
28,552,05287,0,0,0,25,0,3,0,0,0,15,0,0,41066,15,3,0,25,0
28,552,05288,0,0,0,21,11,1,4,0,0,16,5,50,100954,21,5,0,32,0
28,552,05289,0,1,30,32,14,1,3,3,0,16,40,30,120232,56,4,3,46,1
28,552,05290,0,0,0,46,0,12,0,0,0,15,0,0,68962,15,12,0,46,0
28,552,05291,0,0,0,24,0,2,0,0,0,10,0,0,33400,10,2,0,24,0
28,552,05292,0,0,0,17,0,1,0,0,0,7,0,0,36834,7,1,0,17,0
28,552,05293,0,0,0,18,0,2,0,0,0,15,0,0,59462,15,2,0,18,0
28,552,05294,0,0,0,41,0,6,0,0,0,18,0,0,73692,18,6,0,41,0
28,552,05295,0,0,0,42,2,7,0,0,0,13,1,0,50452,14,7,0,44,0
28,552,05296,0,0,0,33,0,3,0,0,0,13,0,0,48559,13,3,0,33,0
28,552,05297,0,0,0,28,0,3,0,0,0,16,0,0,49003,16,3,0,28,0
28,552,05298,0,0,0,40,0,6,0,0,0,28,0,0,79126,28,6,0,40,0
28,552,05299,0,0,0,17,0,3,0,0,0,8,0,0,26079,8,3,0,17,0
28,552,05300,0,0,0,35,0,3,0,0,0,14,0,0,37537,14,3,0,35,0
28,552,05301,0,0,0,24,0,1,0,0,0,13,0,0,53601,13,1,0,24,0
28,552,05302,0,0,0,22,0,2,0,0,0,9,0,0,28156,9,2,0,22,0
28,552,05303,0,0,0,18,0,1,0,0,0,14,0,0,51132,14,1,0,18,0
28,553,05304,0,0,0,25,0,6,0,0,0,12,0,0,46613,12,6,0,25,0
28,553,05305,0,0,0,44,14,1,4,0,0,18,3,40,102691,21,5,0,58,0
28,553,05306,1,0,0,40,0,9,0,0,2,28,0,0,64979,28,9,2,40,1
28,553,05307,1,0,0,84,0,5,0,0,1,30,0,0,55989,30,5,1,84,1
28,553,05308,0,0,0,69,0,8,0,0,0,29,0,0,53476,29,8,0,69,0
28,553,05309,0,1,100,55,48,3,17,10,0,23,34,170,171655,57,20,10,103,1
28,553,05310,0,0,0,45,14,4,4,0,0,20,4,50,88887,24,8,0,59,0
28,553,05311,0,0,0,20,0,3,0,0,0,7,0,0,45771,7,3,0,20,0
28,553,05312,0,0,0,28,0,6,0,0,0,15,0,0,56122,15,6,0,28,0
28,553,05313,0,0,56.25,53,15,9,10.125,5.5,0,21,5,133.125,165872,26,19.125,5.5,68,0
28,553,05314,0,0,0,23,0,3,0,0,0,9,0,0,34629,9,3,0,23,0
28,553,05315,1,0,0,37,0,8,0,0,3,11,0,0,55303,11,8,3,37,1
28,553,05316,0,0,0,45,0,13,0,0,0,19,0,0,50007,19,13,0,45,0
28,553,05317,0,0,0,99,12,3,3,0,0,31,4,30,80201,35,6,0,111,0
28,553,05318,1,0,0,22,0,7,0,0,2,14,0,0,43735,14,7,2,22,1
28,553,05319,0,0,0,24,0,4,0,0,0,11,0,0,49207,11,4,0,24,0
28,553,05320,1,0,0,27,0,3,0,0,1,11,0,0,43162,11,3,1,27,1
28,553,05321,0,0,0,37,5,5,1,0,0,15,5,0,89879,20,6,0,42,0
28,553,05322,1,0,0,36,0,9,0,0,2,22,0,0,38970,22,9,2,36,1
28,553,05323,0,0,0,23,0,2,0,0,0,9,0,0,38312,9,2,0,23,0
28,553,05324,0,0,0,80,0,11,0,0,0,31,0,0,53780,31,11,0,80,0
28,553,05325,0,0,0,56,0,10,0,0,0,14,0,0,43643,14,10,0,56,0
28,553,05326,0,0,0,18,0,5,0,0,0,10,0,0,36858,10,5,0,18,0
28,553,05327,0,0,0,51,0,2,0,0,0,20,0,0,35700,20,2,0,51,0
28,553,05328,0,0,0,29,0,6,0,0,0,13,0,0,54973,13,6,0,29,0
28,553,05329,0,0,0,38,0,2,0,0,0,14,0,0,67384,14,2,0,38,0
28,553,05330,0,1,600,17,223,4,86,58,0,9,320,890,388023,329,90,58,240,1
28,553,05331,0,0,0,18,0,2,0,0,0,8,0,0,31900,8,2,0,18,0
28,553,05332,0,0,0,17,0,1,0,0,0,12,0,0,43172,12,1,0,17,0
28,553,05333,0,0,0,38,0,2,0,0,0,14,0,0,53180,14,2,0,38,0
28,553,05334,1,0,0,65,0,7,0,0,2,26,0,0,50799,26,7,2,65,1
28,553,05335,0,0,0,31,0,3,0,0,0,15,0,0,39673,15,3,0,31,0
28,553,05336,0,0,56.25,21,32,3,10.125,5.5,0,11,13,181.875,172479,24,13.125,5.5,53,0
28,553,05337,1,0,0,23,0,5,0,0,1,12,0,0,39373,12,5,1,23,1
28,553,05338,0,0,0,55,0,5,0,0,0,20,0,0,32373,20,5,0,55,0
28,553,05339,0,0,0,73,0,5,0,0,0,29,0,0,60469,29,5,0,73,0
28,553,05340,0,0,0,25,0,5,0,0,0,11,0,0,42392,11,5,0,25,0
28,553,05341,0,0,0,22,0,2,0,0,0,7,0,0,31404,7,2,0,22,0
28,553,05342,0,0,0,24,0,4,0,0,0,7,0,0,26183,7,4,0,24,0
28,553,05343,1,1,100,42,31,12,12,10,2,14,105,120,125373,119,24,12,73,2
28,553,05344,0,0,0,32,0,11,0,0,0,11,0,0,41376,11,11,0,32,0
28,553,05345,1,0,0,49,0,5,0,0,1,20,0,0,40149,20,5,1,49,1
28,553,05346,0,0,0,44,0,3,0,0,0,21,0,0,39021,21,3,0,44,0
28,553,05347,0,0,0,38,0,5,0,0,0,13,0,0,44351,13,5,0,38,0
28,553,05348,0,0,0,14,0,2,0,0,0,13,0,0,34001,13,2,0,14,0
28,553,05349,0,0,0,75,0,4,0,0,0,27,0,0,51168,27,4,0,75,0
28,553,05350,3,0,0,79,0,20,0,0,6,26,0,0,81227,26,20,6,79,3
28,553,05351,0,0,0,15,0,4,0,0,0,11,0,0,55771,11,4,0,15,0
28,553,05352,0,0,0,26,0,4,0,0,0,9,0,0,52604,9,4,0,26,0
28,553,05353,1,0,0,28,0,10,0,0,2,10,0,0,39964,10,10,2,28,1
28,553,05354,0,0,0,23,0,4,0,0,0,11,0,0,36253,11,4,0,23,0
28,553,05355,0,0,0,19,0,5,0,0,0,12,0,0,58183,12,5,0,19,0
28,553,05356,1,0,0,51,0,14,0,0,2,10,0,0,55381,10,14,2,51,1
28,553,05357,1,0,0,26,0,6,0,0,2,18,0,0,59000,18,6,2,26,1
28,553,05358,0,0,0,43,0,4,0,0,0,15,0,0,48308,15,4,0,43,0
28,553,05359,0,0,0,54,0,4,0,0,0,21,0,0,31036,21,4,0,54,0
28,553,05360,1,0,0,42,0,10,0,0,1,17,0,0,47946,17,10,1,42,1
28,553,05361,0,0,0,17,0,5,0,0,0,9,0,0,29520,9,5,0,17,0
28,553,05362,0,0,0,28,0,5,0,0,0,14,0,0,77234,14,5,0,28,0
28,553,05363,0,0,0,39,0,0,0,0,0,15,0,0,47591,15,0,0,39,0
28,553,05364,0,1,100,91,52,12,19,10,0,30,32,180,203538,62,31,10,143,1
28,553,05365,0,0,0,39,0,6,0,0,0,14,0,0,45122,14,6,0,39,0
28,553,05366,0,0,0,26,0,5,0,0,0,13,0,0,51456,13,5,0,26,0
28,554,05367,1,0,0,36,0,5,0,0,2,16,0,0,45556,16,5,2,36,1
28,554,05368,0,0,0,21,0,2,0,0,0,9,0,0,39914,9,2,0,21,0
28,554,05369,1,0,0,26,0,3,0,0,1,10,0,0,34502,10,3,1,26,1
28,554,05370,0,0,0,49,0,5,0,0,0,25,0,0,42772,25,5,0,49,0
28,554,05371,0,0,0,35,0,4,0,0,0,13,0,0,34294,13,4,0,35,0
28,554,05372,0,0,0,29,0,2,0,0,0,19,0,0,42305,19,2,0,29,0
28,554,05373,1,0,0,22,0,2,0,0,1,8,0,0,26335,8,2,1,22,1
28,554,05374,0,0,0,64,0,3,0,0,0,19,0,0,27994,19,3,0,64,0
28,554,05375,0,0,0,8,0,0,0,0,0,7,1,0,115543,8,0,0,8,0
28,554,05376,0,0,0,54,0,0,0,0,0,20,2,0,75789,22,0,0,54,0
28,554,05377,0,0,0,17,0,2,0,0,0,8,0,0,56403,8,2,0,17,0
28,554,05378,0,1,100,10,49,0,13,10,0,10,18,110,137633,28,13,10,59,1
28,554,05379,0,0,0,129,0,2,0,0,0,48,0,0,43044,48,2,0,129,0
28,554,05380,0,0,0,84,0,1,0,0,0,29,0,0,34176,29,1,0,84,0
28,554,05381,0,0,0,24,0,4,0,0,0,13,0,0,45068,13,4,0,24,0
28,554,05382,0,0,0,35,0,2,0,0,0,17,0,0,42111,17,2,0,35,0
28,554,05383,0,3,850,0,320,0,122,83,0,0,55,1210,407232,55,122,83,320,3
28,554,05384,1,0,0,101,0,4,0,0,1,37,0,0,57284,37,4,1,101,1
28,554,05385,0,0,0,41,0,6,0,0,0,16,0,0,26150,16,6,0,41,0
28,554,05386,0,0,0,29,12,2,4,0,0,16,7,50,73016,23,6,0,41,0
28,554,05387,1,0,0,45,0,4,0,0,1,17,0,0,48729,17,4,1,45,1
28,554,05388,0,0,0,28,0,3,0,0,0,13,0,0,45274,13,3,0,28,0
28,554,05389,0,0,0,19,0,1,0,0,0,12,0,0,41235,12,1,0,19,0
28,554,05390,0,0,0,23,0,2,0,0,0,12,0,0,53067,12,2,0,23,0
28,554,05391,0,0,0,29,0,3,0,0,0,22,0,0,59465,22,3,0,29,0
28,554,05392,0,1,100,35,58,4,27,10,0,17,31,250,233182,48,31,10,93,1
28,554,05393,0,0,0,19,0,2,0,0,0,13,0,0,32890,13,2,0,19,0
28,554,05394,1,0,0,30,0,3,0,0,1,12,0,0,34394,12,3,1,30,1
28,554,05395,0,0,0,77,0,3,0,0,0,30,0,0,37108,30,3,0,77,0
28,554,05396,1,0,0,36,0,4,0,0,1,14,0,0,56663,14,4,1,36,1
28,554,05397,0,0,0,15,0,1,0,0,0,8,0,0,46853,8,1,0,15,0
28,554,05398,0,0,0,21,0,3,0,0,0,10,0,0,31373,10,3,0,21,0
28,554,05399,0,0,0,21,0,2,0,0,0,11,0,0,32407,11,2,0,21,0
28,554,05400,0,0,0,10,0,0,0,0,0,6,0,0,37041,6,0,0,10,0
28,554,05401,1,0,0,60,0,3,0,0,1,22,0,0,31524,22,3,1,60,1
28,554,05402,1,0,0,47,0,6,0,0,1,22,0,0,52979,22,6,1,47,1
28,554,05403,0,0,0,27,0,2,0,0,0,13,0,0,34026,13,2,0,27,0
28,554,05404,0,0,0,16,0,1,0,0,0,9,0,0,28993,9,1,0,16,0
28,554,05405,1,0,0,36,0,3,0,0,1,14,0,0,30048,14,3,1,36,1
28,554,05406,0,1,30,64,20,0,4,3,0,25,8,30,96152,33,4,3,84,1
28,554,05407,0,0,0,12,12,1,3,0,0,6,8,30,79166,14,4,0,24,0
28,554,05408,0,0,0,20,0,3,0,0,0,9,0,0,47764,9,3,0,20,0
28,554,05409,0,0,0,16,0,1,0,0,0,11,0,0,41517,11,1,0,16,0
28,554,05410,0,0,0,93,0,5,0,0,0,34,0,0,46412,34,5,0,93,0
28,554,05411,2,0,0,37,0,5,0,0,2,15,0,0,50631,15,5,2,37,2
28,554,05412,0,0,0,77,0,3,0,0,0,24,0,0,43528,24,3,0,77,0
28,554,05413,0,0,0,51,0,1,0,0,0,18,0,0,42103,18,1,0,51,0
28,554,05414,1,0,0,80,0,5,0,0,1,27,0,0,49202,27,5,1,80,1
28,554,05415,0,0,0,57,13,2,4,0,0,24,8,50,109702,32,6,0,70,0
28,554,05416,0,0,0,93,0,4,0,0,0,34,0,0,58423,34,4,0,93,0
28,554,05417,0,0,0,35,0,3,0,0,0,14,0,0,53598,14,3,0,35,0
28,554,05418,0,0,0,40,0,1,0,0,0,17,0,0,53708,17,1,0,40,0
28,554,05419,0,0,0,37,0,2,0,0,0,14,0,0,38926,14,2,0,37,0
28,554,05420,0,0,0,102,0,2,0,0,0,36,0,0,69543,36,2,0,102,0
28,554,05421,0,1,300,112,89,1,45,20,0,40,18,580,212816,58,46,20,201,1
28,554,05422,0,1,50,54,18,1,7,5,0,20,16,70,81470,36,8,5,72,1
28,554,05423,0,0,0,30,0,2,0,0,0,12,0,0,56526,12,2,0,30,0
28,554,05424,1,0,0,56,0,5,0,0,2,26,0,0,88296,26,5,2,56,1
28,554,05425,0,0,0,15,0,2,0,0,0,5,0,0,61775,5,2,0,15,0
28,554,05426,0,0,0,12,0,0,0,0,0,8,0,0,45004,8,0,0,12,0
28,554,05427,0,1,100,6,46,2,11,10,0,1,9,100,120479,10,13,10,52,1
28,554,05428,0,0,0,22,0,7,0,0,0,9,0,0,57810,9,7,0,22,0
28,554,05429,0,0,0,43,0,6,0,0,0,20,0,0,73199,20,6,0,43,0
28,554,05430,0,0,0,35,0,1,0,0,0,15,0,0,50144,15,1,0,35,0
28,554,05431,0,0,0,118,0,6,0,0,0,43,0,0,43306,43,6,0,118,0
28,554,05432,0,0,0,67,0,1,0,0,0,23,0,0,23625,23,1,0,67,0
29,555,05433,0,2,130,463,154,164,39,13,0,180,22,298,628757,202,203,13,617,2
29,555,05434,0,1,100,314,93,139,28,11,0,136,12,215,525832,148,167,11,407,1
29,555,05435,0,2,130,163,131,72,41,15,0,74,13,293,405489,87,113,15,294,2
29,555,05436,0,2,130,263,138,137,39,14,0,149,29,313,612163,178,176,14,401,2
29,555,05437,0,2,130,381,110,153,45,18,0,128,9,283,399270,137,198,18,491,2
29,555,05438,0,1,1000,217,943,82,227,98,0,98,49,2144,957373,147,309,98,1160,1
29,555,05439,0,1,100,200,131,86,22,7,0,80,9,230,258031,89,108,7,331,1
29,555,05440,0,1,100,270,99,125,24,9,0,118,10,210,381154,128,149,9,369,1
29,555,05441,0,1,100,359,91,135,26,11,0,125,5,209,352919,130,161,11,450,1
29,555,05442,0,1,100,121,84,59,21,8,0,61,9,225,258527,70,80,8,205,1
29,556,05443,0,3,160,185,106,80,56,11,0,75,19,389,470176,94,136,11,291,3
29,556,05444,0,1,100,104,25,38,18,3,0,34,5,218,160261,39,56,3,129,1
29,556,05445,0,1,100,173,33,68,24,8,0,59,7,216,285915,66,92,8,206,1
29,556,05446,0,3,160,168,170,80,45,9,0,65,23,371,330845,88,125,9,338,3
29,556,05447,0,2,250,142,180,57,53,13,0,50,10,626,285114,60,110,13,322,2
29,556,05448,0,2,150,268,132,87,63,5,0,71,35,412,321330,106,150,5,400,2
29,556,99999,0,1,30,0,53,0,18,2,0,0,10,98,36055,10,18,2,53,1
29,557,05449,0,1,400,401,284,77,53,18,0,108,21,904,721075,129,130,18,685,1
29,557,05450,0,1,100,364,70,79,7,2,0,103,6,208,421169,109,86,2,434,1
29,557,05451,0,1,100,333,30,81,17,7,0,88,6,208,395675,94,98,7,363,1
29,557,05452,0,1,100,389,54,70,13,5,0,89,5,208,348721,94,83,5,443,1
29,557,05453,0,2,130,225,125,50,25,4,0,81,9,333,290691,90,75,4,350,2
29,558,05454,0,1,100,297,48,124,26,10,0,96,7,230,345247,103,150,10,345,1
29,558,05455,0,1,100,284,29,98,15,5,0,74,5,229,277350,79,113,5,313,1
29,558,05456,0,2,130,191,46,82,35,11,0,73,8,312,278400,81,117,11,237,2
29,558,05457,0,1,1400,162,124,90,88,32,0,68,53,2867,469941,121,178,32,286,1
29,558,05458,0,1,100,285,20,104,21,7,0,93,12,229,332362,105,125,7,305,1
29,559,05459,0,2,130,285,152,71,77,12,0,75,22,572,385621,97,148,12,437,2
29,559,05460,0,1,100,167,65,56,34,5,0,61,7,273,280569,68,90,5,232,1
29,559,05461,0,2,1200,129,52,37,32,14,0,58,14,1236,498606,72,69,14,181,2
29,559,05462,0,1,100,343,61,50,33,5,0,73,9,257,370647,82,83,5,404,1
29,559,05463,0,1,100,303,89,48,48,7,0,71,16,267,393135,87,96,7,392,1
29,560,05464,0,1,100,273,24,64,12,4,0,73,4,209,267442,77,76,4,297,1
29,560,05465,0,1,100,155,23,34,13,4,0,53,5,210,284763,58,47,4,178,1
29,560,05466,0,1,100,272,60,58,23,6,0,85,14,244,459861,99,81,6,332,1
29,560,05467,0,2,130,261,90,65,37,11,0,70,15,311,377719,85,102,11,351,2
29,561,05468,0,1,100,92,26,15,15,5,0,26,3,209,100623,29,30,5,118,1
29,561,05469,0,2,130,253,120,36,47,9,0,72,28,369,264123,100,83,9,373,2
29,561,05470,0,1,300,233,185,45,50,11,0,74,37,813,367258,111,95,11,418,1
29,561,05471,0,2,130,130,89,18,39,10,0,46,19,324,200611,65,57,10,219,2
29,561,05472,0,1,100,122,24,27,17,6,0,48,2,210,131897,50,44,6,146,1
29,562,05473,0,0,0,270,9,18,4,0,0,61,6,21,249988,67,22,0,279,0
29,562,05474,0,1,100,171,77,19,31,12,0,50,12,229,190208,62,50,12,248,1
29,562,05475,0,0,0,273,0,30,0,0,0,56,0,0,142760,56,30,0,273,0
29,562,05476,0,1,100,182,66,32,29,13,0,44,5,208,154594,49,61,13,248,1
29,562,05477,0,1,100,180,68,27,29,13,0,46,5,208,165568,51,56,13,248,1
29,563,05478,0,1,400,173,210,33,107,45,0,56,10,870,155213,66,140,45,383,1
29,563,05479,0,0,0,157,0,26,0,0,0,49,0,0,51703,49,26,0,157,0
29,563,05480,0,1,100,142,66,21,25,11,0,46,12,208,119211,58,46,11,208,1
29,563,05481,0,1,100,120,78,23,37,12,0,44,11,248,78438,55,60,12,198,1
29,563,05482,0,1,100,65,67,17,29,10,0,32,7,223,105994,39,46,10,132,1
29,563,05483,0,1,100,151,87,34,43,10,0,57,15,296,186735,72,77,10,238,1
29,563,05484,0,1,100,116,61,13,24,9,0,32,4,209,107148,36,37,9,177,1
29,563,05485,0,1,100,160,66,28,32,11,0,44,7,240,154069,51,60,11,226,1
29,563,05486,0,1,100,99,56,19,26,11,0,44,4,209,96762,48,45,11,155,1
29,563,05487,0,1,100,178,66,29,32,12,0,61,8,228,166178,69,61,12,244,1
29,563,05488,0,1,100,124,57,20,27,11,0,37,4,209,161537,41,47,11,181,1
29,564,05489,0,2,130,162,71,26,28,9,0,52,11,277,187910,63,54,9,233,2
29,564,05490,0,1,100,165,36,21,14,5,0,44,2,209,161521,46,35,5,201,1
29,564,05491,0,1,30,251,49,50,19,6,0,82,6,68,260455,88,69,6,300,1
29,564,05492,0,1,250,268,88,52,28,12,0,73,9,509,280362,82,80,12,356,1
29,564,05493,0,1,100,106,42,15,9,3,0,37,10,208,141024,47,24,3,148,1
29,564,05494,0,1,100,238,38,40,11,4,0,80,6,208,231115,86,51,4,276,1
29,564,05495,0,1,100,279,46,41,15,4,0,74,11,221,335281,85,56,4,325,1
29,565,05496,0,1,100,175,50,40,16,5,0,48,4,215,195207,52,56,5,225,1
29,565,05497,0,0,0,156,0,35,0,0,0,63,0,0,188238,63,35,0,156,0
29,565,05498,0,2,130,160,140,29,45,13,0,49,25,407,459951,74,74,13,300,2
29,565,05499,0,2,130,143,101,26,42,16,0,59,12,283,269045,71,68,16,244,2
29,565,05500,0,3,1398,324,355,63,157,42,0,111,33,4001,770929,144,220,42,679,3
29,565,05501,0,1,100,155,65,21,26,11,0,46,12,214,260107,58,47,11,220,1
29,565,05502,0,2,130,203,130,34,48,12,0,72,13,296,308893,85,82,12,333,2
29,566,05503,0,1,100,95,68,18,15,6,0,25,6,208,141131,31,33,6,163,1
29,566,05504,0,1,100,289,89,61,37,7,0,87,16,283,365601,103,98,7,378,1
29,566,05505,0,2,480,268,280,61,66,25,0,77,17,1020,423781,94,127,25,548,2
29,566,05506,0,1,100,292,54,49,13,5,0,76,8,208,207219,84,62,5,346,1
29,566,05507,0,2,130,261,98,44,21,5,0,72,13,296,234872,85,65,5,359,2
29,566,05508,0,1,100,359,102,72,30,6,0,93,14,268,286057,107,102,6,461,1
29,567,05509,0,1,100,171,58,36,25,8,0,57,9,234,254143,66,61,8,229,1
29,567,05510,0,1,100,238,133,59,55,9,0,86,23,317,302003,109,114,9,371,1
29,567,05511,0,1,100,157,94,29,41,11,0,53,13,258,171780,66,70,11,251,1
29,567,05512,0,1,950,305,563,72,198,52,0,118,75,2289,681891,193,270,52,868,1
29,567,05513,0,1,100,196,123,42,38,7,0,76,18,264,233072,94,80,7,319,1
29,567,05514,0,1,100,311,167,71,67,8,0,102,28,376,302240,130,138,8,478,1
29,568,05515,0,1,100,234,78,46,38,8,0,67,19,295,205902,86,84,8,312,1
29,568,05516,0,1,100,253,36,62,21,9,0,88,4,208,200344,92,83,9,289,1
29,568,05517,0,2,180,277,79,58,29,11,0,68,20,376,238095,88,87,11,356,2
29,568,05518,0,1,100,196,78,37,39,9,0,68,14,288,117822,82,76,9,274,1
29,568,05519,0,1,100,325,82,53,28,10,0,91,25,228,141737,116,81,10,407,1
29,568,05520,0,1,1000,189,408,45,80,12,0,52,52,2228,507138,104,125,12,597,1
29,568,05521,0,1,100,194,52,43,33,10,0,67,17,248,339763,84,76,10,246,1
29,569,05522,0,1,100,414,91,91,39,10,0,164,24,304,398471,188,130,10,505,1
29,569,05523,0,2,280,358,289,85,116,19,0,150,84,913,562799,234,201,19,647,2
29,569,05524,0,1,100,339,58,83,25,10,0,107,10,213,216091,117,108,10,397,1
29,570,05525,0,1,100,84,48,19,20,8,0,23,4,209,36530,27,39,8,132,1
29,570,05526,0,1,100,180,108,31,41,7,0,63,19,312,84704,82,72,7,288,1
29,570,05527,0,1,100,92,84,14,42,10,0,30,14,285,66090,44,56,10,176,1
29,570,05528,0,1,100,245,126,61,59,6,0,97,23,394,225089,120,120,6,371,1
29,570,05529,0,2,150,401,145,114,53,12,0,138,23,403,291334,161,167,12,546,2
29,570,05530,0,1,400,245,414,60,94,22,0,96,31,1074,305034,127,154,22,659,1
29,570,05531,0,2,150,263,115,65,62,16,0,97,17,399,127934,114,127,16,378,2
29,571,05532,0,1,100,204,46,50,17,5,0,68,9,239,211781,77,67,5,250,1
29,571,05533,0,1,100,210,90,59,39,11,0,79,9,266,313324,88,98,11,300,1
29,571,05534,0,1,100,166,82,34,22,9,0,63,13,208,245044,76,56,9,248,1
29,571,05535,0,1,100,235,82,58,18,7,0,81,3,209,267423,84,76,7,317,1
29,571,05536,0,1,100,162,34,41,24,10,0,57,3,209,167238,60,65,10,196,1
29,571,05537,0,1,400,285,115,55,74,26,0,86,24,911,591629,110,129,26,400,1
29,571,05538,0,1,100,257,52,73,15,6,0,75,5,208,261975,80,88,6,309,1
29,571,05539,0,1,100,139,71,36,36,11,0,49,10,270,222574,59,72,11,210,1
29,571,05540,0,1,100,149,42,40,21,9,0,60,7,208,168698,67,61,9,191,1
29,571,05541,0,1,100,207,70,62,27,12,0,89,7,208,225400,96,89,12,277,1
29,572,05542,0,0,0,201,27,41,12,0,0,63,16,63,328547,79,53,0,228,0
29,572,05543,0,0,0,134,4,26,0,0,0,41,6,0,185165,47,26,0,138,0
29,572,05544,0,0,0,48,0,12,0,0,0,13,0,0,94434,13,12,0,48,0
29,572,05545,0,1,100,124,83,26,31,8,0,66,41,271,517290,107,57,8,207,1
29,572,99999,0,21,7088,0,4458,0,650,285,0,0,277,15235,8443675,277,650,285,4458,21
29,573,05546,0,1,100,267,90,69,40,12,0,110,11,274,260216,121,109,12,357,1
29,573,05547,0,1,100,223,58,57,26,11,0,103,3,209,187700,106,83,11,281,1
29,573,05548,0,2,130,124,92,26,48,16,0,54,13,307,183308,67,74,16,216,2
29,573,05549,0,1,100,173,56,33,26,11,0,54,2,209,179964,56,59,11,229,1
29,573,05550,0,1,1000,406,464,111,258,120,0,149,14,2085,415092,163,369,120,870,1
29,573,05551,0,1,100,304,81,75,34,11,0,110,8,242,295412,118,109,11,385,1
29,573,05552,0,1,100,296,58,77,27,11,0,101,6,215,283197,107,104,11,354,1
29,574,05553,0,1,150,194,50,38,26,11,0,66,5,309,128341,71,64,11,244,1
29,574,05554,0,1,100,208,26,44,22,9,0,72,4,209,183637,76,66,9,234,1
29,574,05555,0,1,150,402,50,78,32,14,0,126,4,309,315013,130,110,14,452,1
29,574,05556,0,1,1000,392,206,75,105,45,0,121,17,2069,395944,138,180,45,598,1
29,574,05557,0,1,100,71,52,15,27,9,0,30,6,224,84782,36,42,9,123,1
29,574,05558,0,1,100,293,60,58,25,8,0,97,7,224,204304,104,83,8,353,1
29,574,05559,0,1,250,333,122,66,54,18,0,87,12,562,182064,99,120,18,455,1
29,574,05560,0,1,100,475,72,77,29,11,0,141,13,224,279342,154,106,11,547,1
29,575,05561,0,4,1025,306,780,33,273,66,0,94,155,2556,994602,249,306,66,1086,4
29,575,05562,0,2,130,351,161,57,57,12,0,127,40,399,395380,167,114,12,512,2
29,575,05563,0,1,100,376,134,56,34,12,0,124,12,228,266589,136,90,12,510,1
29,575,05564,0,2,130,338,141,53,39,13,0,119,23,292,287851,142,92,13,479,2
29,575,05565,0,1,100,196,67,18,27,8,0,66,11,234,145227,77,45,8,263,1
29,576,05566,0,1,400,200,274,28,57,23,0,77,10,825,146583,87,85,23,474,1
29,576,05567,0,2,180,299,128,69,38,9,0,117,11,399,206330,128,107,9,427,2
29,576,05568,0,2,240,282,129,52,33,7,0,113,16,518,201431,129,85,7,411,2
29,577,05569,0,2,106,274,76,71,37,13,0,103,10,248,242952,113,108,13,350,2
29,577,05570,0,4,118,311,115,72,57,14,0,104,23,334,282751,127,129,14,426,4
29,577,05571,0,4,118,263,104,58,53,13,0,90,16,328,252586,106,111,13,367,4
29,577,05572,0,13,1584,176,858,46,491,181,0,98,120,3651,1281719,218,537,181,1034,13
29,577,05573,0,5,148,266,141,63,64,16,0,97,26,394,263486,123,127,16,407,5
29,577,05574,0,4,148,361,127,81,69,19,0,126,18,400,384910,144,150,19,488,4
29,577,05575,0,8,172,199,200,52,101,23,0,87,43,548,292035,130,153,23,399,8
29,578,05576,0,1,100,281,139,72,39,7,0,119,18,265,222871,137,111,7,420,1
29,578,05577,0,1,250,262,100,75,51,17,0,116,16,551,357373,132,126,17,362,1
29,578,05578,0,1,100,56,56,16,25,6,0,28,9,235,82069,37,41,6,112,1
29,578,05579,0,1,150,249,131,67,51,11,0,106,24,425,357834,130,118,11,380,1
29,579,05580,0,1,100,266,88,62,26,7,0,91,16,242,342207,107,88,7,354,1
29,579,05581,0,1,100,236,112,44,20,5,0,57,10,238,220339,67,64,5,348,1
29,579,05582,0,1,100,212,68,33,34,12,0,74,74,230,829830,148,67,12,280,1
29,579,05583,0,1,100,223,96,69,21,9,0,67,5,208,254252,72,90,9,319,1
29,579,05584,0,1,100,157,156,46,26,10,0,47,9,235,218572,56,72,10,313,1
29,579,05585,0,4,190,249,150,83,54,20,0,91,19,387,404188,110,137,20,399,4
29,579,05586,0,1,850,235,1114,50,149,33,0,73,67,2058,296879,140,199,33,1349,1
29,580,05587,0,1,100,183,29,47,10,5,0,66,2,134,412169,68,57,5,212,1
29,580,05588,0,2,106,230,30,57,18,5,0,81,9,141,363553,90,75,5,260,2
29,580,05589,0,2,130,226,52,60,29,12,0,80,8,201,398322,88,89,12,278,2
29,581,05590,0,1,100,167,50,39,19,7,0,55,11,158,202074,66,58,7,217,1
29,581,05591,0,2,400,195,153,43,53,22,0,67,38,528,385015,105,96,22,348,2
29,581,05592,0,1,100,175,32,29,13,9,0,63,13,130,236612,76,42,9,207,1
29,581,05593,0,3,405,152,129,21,40,22,0,59,35,491,452553,94,61,22,281,3
29,581,05594,0,1,100,245,44,58,23,12,0,76,13,169,258678,89,81,12,289,1
29,582,05595,0,1,110,294,54,60,28,8,0,81,13,269,290680,94,88,8,348,1
29,582,05596,0,1,100,89,44,15,19,8,0,37,9,208,212358,46,34,8,133,1
29,582,05597,0,1,100,37,37,11,17,7,0,15,6,208,55738,21,28,7,74,1
29,582,05598,0,1,100,139,78,28,37,12,0,37,12,259,183376,49,65,12,217,1
29,582,05599,0,1,100,162,42,30,21,9,0,48,7,208,213943,55,51,9,204,1
29,582,05600,0,1,150,181,57,31,34,12,0,72,9,334,297743,81,65,12,238,1
29,583,05601,0,1,100,290,60,27,20,5,0,69,12,228,210541,81,47,5,350,1
29,583,05602,0,1,100,450,103,46,37,7,0,89,18,266,299281,107,83,7,553,1
29,583,05603,0,2,130,335,96,33,38,11,0,62,17,316,209387,79,71,11,431,2
29,583,05604,0,1,100,344,69,30,30,9,0,68,15,232,270499,83,60,9,413,1
29,584,05605,0,2,130,203,96,48,35,16,0,84,12,266,203584,96,83,16,299,2
29,584,05606,0,2,130,191,124,50,39,14,0,74,10,283,266443,84,89,14,315,2
29,584,05607,0,1,100,199,54,42,26,10,0,89,13,211,261278,102,68,10,253,1
29,584,05608,0,1,100,284,43,65,24,9,0,118,10,215,350711,128,89,9,327,1
30,585,05609,0,0,0,83,45,34,14,0,0,15,8,45,75747,23,48,0,128,0
30,585,05610,0,1,190,57,456,28,83,60,0,16,47,234,237440,63,111,60,513,1
30,585,05611,0,3,1566,43,289,24,250,201,0,11,37,1780,177219,48,274,201,332,3
30,585,05612,0,0,0,53,62,22,15,0,0,14,10,85,97955,24,37,0,115,0
30,585,05613,0,0,0,69,57,38,11,0,0,21,3,31,63743,24,49,0,126,0
30,585,05614,0,1,6,165,59,101,12,4,0,24,29,25,165830,53,113,4,224,1
30,586,05615,1,5,230,56,232,27,82,61,15,6,24,245,154561,30,109,76,288,6
30,586,05616,2,3,314,65,239,21,76,59,4,32,54,384,294464,86,97,63,304,5
30,586,05617,0,0,0,38,49,16,11,0,0,13,11,62,81193,24,27,0,87,0
30,586,05618,0,0,0,44,41,25,7,0,0,21,4,21,64974,25,32,0,85,0
30,586,05619,0,0,0,31,43,11,9,0,0,10,4,70,45172,14,20,0,74,0
31,587,05620,0,0,0,0,12,0,2,0,0,0,1,10,7661,1,2,0,12,0
31,587,05621,0,0,0,4,0,2,0,0,0,2,0,0,271,2,2,0,4,0
31,587,05622,0,0,0,6,0,1,0,0,0,3,0,0,2347,3,1,0,6,0
31,587,05623,0,0,0,6,0,1,0,0,0,3,0,0,3946,3,1,0,6,0
31,587,05624,0,0,0,0,14,0,3,0,0,0,5,30,5404,5,3,0,14,0
31,587,05625,0,0,0,0,18,0,3,0,0,0,1,10,11210,1,3,0,18,0
31,587,05626,0,0,0,21,0,2,0,0,0,3,0,0,7521,3,2,0,21,0
31,587,05627,0,1,50,0,41,0,7,6,0,0,3,50,11191,3,7,6,41,1
31,587,05628,0,0,0,0,36,0,4,0,0,0,2,30,4419,2,4,0,36,0
31,587,05629,0,1,20,0,27,0,5,4,0,0,4,20,10447,4,5,4,27,1
32,588,05630,0,2,272,355,288,150,118,13,0,139,69,957,681734,208,268,13,643,2
32,588,05631,0,1,340,317,400,118,85,25,0,109,63,878,625641,172,203,25,717,1
32,589,05632,0,2,360,299,231,125,82,35,0,134,42,495,764888,176,207,35,530,2
32,589,05633,1,2,665,46,311,13,155,41,3,5,106,941,784984,111,168,44,357,3
32,589,05634,0,1,541,275,179,108,108,37,0,90,65,587,973131,155,216,37,454,1
32,590,05635,1,0,0,337,0,99,0,0,27,78,0,0,258140,78,99,27,337,1
32,590,05636,1,0,0,304,0,106,0,0,6,101,0,0,297863,101,106,6,304,1
32,590,05637,0,1,43,231,34,73,16,5,0,75,13,143,261417,88,89,5,265,1
32,591,05638,0,1,210,131,140,52,55,16,0,72,37,328,687265,109,107,16,271,1
32,591,05639,0,1,159,233,159,77,61,12,0,93,40,321,728168,133,138,12,392,1
32,591,05640,0,10,4167,260,835,70,365,284,0,99,104,4373,1670860,203,435,284,1095,10
32,592,05641,0,2,541,459,201,146,81,44,0,124,60,624,910978,184,227,44,660,2
32,592,05642,0,0,0,308,22,113,3,0,0,113,9,10,574059,122,116,0,330,0
32,592,05643,0,2,240,270,54,93,9,4,0,90,17,250,606396,107,102,4,324,2
32,592,05644,0,2,202,294,129,110,36,14,0,102,57,202,928672,159,146,14,423,2
32,592,05645,0,1,125,58,302,20,96,20,0,16,58,186,713017,74,116,20,360,1
32,592,05646,0,2,170,110,77,37,31,13,0,47,30,194,379798,77,68,13,187,2
32,593,05647,0,5,437,542,336,199,104,34,0,186,51,707,930692,237,303,34,878,5
32,593,05648,1,1,123,324,59,124,15,11,8,118,9,153,384393,127,139,19,383,2
32,593,05649,2,2,637,281,275,110,75,39,4,87,25,712,612116,112,185,43,556,4
32,593,05650,3,2,188,312,37,119,24,18,15,99,14,208,437738,113,143,33,349,5
32,593,05651,0,1,154,381,70,140,18,15,0,125,4,154,444995,129,158,15,451,1
32,594,05652,0,7,761,211,291,61,121,85,0,58,52,846,632086,110,182,85,502,7
32,594,05653,2,4,242,178,233,41,66,23,5,43,58,260,470898,101,107,28,411,6
32,594,05654,1,11,3664,214,501,253,135,46,227,23,103,3916,874615,126,388,273,715,12
32,594,05655,0,2,206,45,187,13,44,16,0,10,35,268,312238,45,57,16,232,2
32,594,05656,1,6,1506,419,423,109,140,52,3,150,113,1608,831363,263,249,55,842,7
32,595,05657,1,1,300,322,165,88,71,12,2,84,27,359,469164,111,159,14,487,2
32,595,05658,0,2,319,100,189,43,70,17,0,54,69,585,468408,123,113,17,289,2
32,595,05659,0,4,318,54,220,9,55,20,0,11,46,373,410571,57,64,20,274,4
32,595,05660,1,5,813,85,166,30,51,38,3,30,42,900,508212,72,81,41,251,6
32,595,05661,0,6,1013,65,432,23,172,60,0,17,166,1339,851406,183,195,60,497,6
32,595,05662,1,1,266,364,65,103,49,16,4,84,42,306,336224,126,152,20,429,2
32,595,05663,1,1,123,173,31,55,17,10,2,49,8,153,238403,57,72,12,204,2
32,596,05664,0,0,0,111,0,49,0,0,0,60,0,0,177621,60,49,0,111,0
32,596,05665,1,0,0,536,0,148,0,0,5,149,0,0,429780,149,148,5,536,1
32,596,05666,0,1,144,356,112,128,63,11,0,136,46,329,325951,182,191,11,468,1
32,596,05667,1,0,0,244,0,55,0,0,2,73,0,0,175622,73,55,2,244,1
32,597,05668,0,1,350,388,76,140,30,17,0,140,20,395,406471,160,170,17,464,1
32,597,05669,0,1,400,242,57,85,23,20,0,95,4,400,310414,99,108,20,299,1
32,597,05670,0,3,1620,225,263,82,101,34,0,107,88,1886,631885,195,183,34,488,3
32,597,05671,0,1,477,134,91,59,37,29,0,78,21,477,355736,99,96,29,225,1
32,597,05672,0,0,0,216,0,80,0,0,0,95,0,0,270045,95,80,0,216,0
32,598,05673,0,1,251,143,174,48,80,14,0,57,78,306,542657,135,128,14,317,1
32,598,05674,0,4,1700,74,537,19,288,249,0,28,43,1859,454864,71,307,249,611,4
32,598,05675,2,0,0,308,0,96,0,0,8,102,0,0,193007,102,96,8,308,2
32,598,05676,2,2,50,144,143,45,42,9,2,36,66,155,406524,102,87,11,287,4
32,598,05677,0,1,140,150,64,50,25,13,0,63,12,145,197419,75,75,13,214,1
32,598,05678,1,0,0,266,47,55,17,0,3,66,30,0,333318,96,72,3,313,1
32,599,05679,0,1,173,161,101,65,16,12,0,63,9,218,223503,72,81,12,262,1
32,599,05680,2,0,0,194,0,62,0,0,6,55,0,0,134219,55,62,6,194,2
32,599,05681,2,0,0,326,0,102,0,0,18,75,0,0,198194,75,102,18,326,2
32,599,05682,1,3,434,309,162,117,58,35,6,116,35,434,338560,151,175,41,471,4
32,599,05683,0,0,0,205,0,76,0,0,0,83,6,0,302936,89,76,0,205,0
32,600,05684,0,2,260,77,228,33,73,28,0,52,65,430,428802,117,106,28,305,2
32,600,05685,0,0,0,214,0,40,0,0,0,60,0,0,199456,60,40,0,214,0
32,600,05686,0,1,144,359,29,100,11,8,0,126,25,169,432904,151,111,8,388,1
32,600,05687,0,1,217,349,55,135,13,8,0,157,14,227,586434,171,148,8,404,1
32,600,05688,0,7,1075,128,537,42,120,46,0,50,139,1174,987779,189,162,46,665,7
32,601,05689,0,2,114,344,108,129,39,11,0,163,39,259,634270,202,168,11,452,2
32,601,05690,0,1,225,457,29,136,29,20,0,130,17,250,645326,147,165,20,486,1
32,601,05691,0,13,6281,57,880,19,377,242,0,22,175,9257,1140845,197,396,242,937,13
32,601,05692,0,2,555,257,223,75,81,28,0,94,55,775,880986,149,156,28,480,2
33,602,05693,0,1,15,207,30,64,9,2,0,89,9,38,190496,98,73,2,237,1
33,602,05694,0,1,32,384,142,127,49,4,0,156,40,181,389814,196,176,4,526,1
33,602,05695,0,1,10,140,32,33,9,1,0,63,7,30,152631,70,42,1,172,1
33,602,05696,0,1,48,208,78,46,24,15,0,78,13,73,211291,91,70,15,286,1
33,602,05697,0,2,30,77,138,18,41,3,0,51,23,129,214073,74,59,3,215,2
33,602,05698,0,1,58,251,129,66,44,22,0,125,65,170,407030,190,110,22,380,1
33,602,05699,0,2,419,38,236,8,80,48,0,27,51,518,597098,78,88,48,274,2
33,602,05700,0,2,540,85,330,29,105,66,0,29,87,698,904706,116,134,66,415,2
33,602,05701,0,2,371,18,303,5,106,39,0,14,79,582,596156,93,111,39,321,2
33,603,99999,0,69,4520,0,3894,0,1235,800,0,0,2155,6348,4646732,2155,1235,800,3894,69
33,604,05702,0,1,25,177,200,44,61,6,0,88,65,192,493504,153,105,6,377,1
33,604,05703,0,3,390,4,510,0,176,93,0,10,64,825,383718,74,176,93,514,3
33,604,05704,0,3,268,0,273,0,107,59,0,0,109,443,419750,109,107,59,273,3
33,604,05705,0,1,45,82,150,18,54,19,0,48,65,168,544775,113,72,19,232,1
33,604,05706,0,1,75,334,220,93,68,20,0,128,63,246,573366,191,161,20,554,1
33,604,05707,0,2,183,158,436,38,143,47,0,68,63,336,497644,131,181,47,594,2
33,604,05708,0,1,32,110,33,27,13,7,0,63,20,52,148038,83,40,7,143,1
33,604,05709,0,2,55,101,75,23,23,6,0,48,22,125,196897,70,46,6,176,2
33,604,05710,0,1,18,125,82,31,37,16,0,71,18,133,275941,89,68,16,207,1
33,604,05711,0,1,30,182,43,52,12,5,0,85,8,70,206011,93,64,5,225,1
33,605,05712,0,2,160,176,173,43,46,25,0,78,81,242,425353,159,89,25,349,2
33,605,05713,0,2,59,188,160,47,53,10,0,94,61,192,391100,155,100,10,348,2
33,605,05714,0,4,240,154,288,38,93,45,0,82,58,369,444758,140,131,45,442,4
33,605,05715,0,1,75,241,216,59,60,19,0,118,65,236,504026,183,119,19,457,1
33,605,05716,0,2,95,115,127,32,33,5,0,59,53,193,250491,112,65,5,242,2
33,605,05717,0,5,298,167,385,40,116,33,0,94,141,660,696110,235,156,33,552,5
33,605,05718,0,1,90,200,118,49,30,15,0,78,37,170,336514,115,79,15,318,1
33,605,05719,0,1,80,125,92,35,17,9,0,67,45,148,326211,112,52,9,217,1
33,605,05720,0,2,90,420,132,106,39,12,0,154,45,204,561708,199,145,12,552,2
33,606,05721,0,1,65,171,147,48,38,8,0,69,31,189,294976,100,86,8,318,1
33,606,05722,0,1,72,325,113,108,24,16,0,114,38,96,338596,152,132,16,438,1
33,606,05723,0,1,54,328,79,115,24,3,0,119,16,127,336121,135,139,3,407,1
33,606,05724,0,1,38,346,97,115,27,9,0,160,27,131,449832,187,142,9,443,1
33,606,05725,0,1,10,237,51,76,15,2,0,96,17,115,283882,113,91,2,288,1
33,606,05726,1,0,0,249,0,85,0,0,5,83,0,0,179531,83,85,5,249,1
33,606,05727,0,1,362,394,155,128,47,26,0,138,53,472,581836,191,175,26,549,1
33,607,05728,0,1,20,377,75,78,23,6,0,141,11,118,423942,152,101,6,452,1
33,607,05729,0,2,86,446,150,113,34,18,0,161,43,146,446682,204,147,18,596,2
33,607,05730,0,1,31,80,36,21,13,6,0,54,7,46,196376,61,34,6,116,1
33,607,05731,0,2,130,494,189,114,53,28,0,225,44,220,697462,269,167,28,683,2
33,607,05732,0,1,35,293,94,67,32,8,0,131,46,103,446531,177,99,8,387,1
33,607,05733,0,1,32,275,39,65,10,3,0,156,7,52,407925,163,75,3,314,1
33,607,05734,0,1,96,239,211,46,54,24,0,136,43,238,466081,179,100,24,450,1
33,607,05735,0,1,10,235,50,55,15,8,0,107,6,30,373621,113,70,8,285,1
33,608,05736,0,2,85,284,299,68,63,15,0,116,62,245,419887,178,131,15,583,2
33,608,05737,0,1,20,554,146,156,43,12,0,214,43,136,494355,257,199,12,700,1
33,608,05738,0,1,50,258,97,70,35,8,0,85,24,138,223756,109,105,8,355,1
33,608,05739,0,1,58,158,164,52,41,8,0,68,41,168,241783,109,93,8,322,1
33,608,05740,0,3,865,281,749,84,161,79,0,108,100,1277,1272743,208,245,79,1030,3
33,608,05741,0,1,25,46,33,11,10,3,0,17,9,44,41668,26,21,3,79,1
33,608,05742,0,0,0,105,61,29,20,0,0,60,37,72,195412,97,49,0,166,0
33,608,05743,0,3,109,372,230,103,64,24,0,145,77,312,430929,222,167,24,602,3
33,608,05744,0,1,61,55,120,16,36,5,0,38,46,213,161302,84,52,5,175,1
33,609,05745,0,3,208,507,343,143,92,30,0,173,118,477,631507,291,235,30,850,3
33,609,05746,0,2,88,217,210,65,68,19,0,112,61,231,340515,173,133,19,427,2
33,609,05747,0,2,124,420,209,129,62,18,0,208,75,288,541488,283,191,18,629,2
33,609,05748,0,1,44,245,103,82,30,6,0,75,31,149,213091,106,112,6,348,1
33,610,05749,0,2,70,204,125,53,42,11,0,114,54,177,327441,168,95,11,329,2
33,610,05750,0,2,59,554,203,156,63,16,0,183,92,223,459517,275,219,16,757,2
33,610,05751,0,1,60,171,208,51,60,13,0,85,54,276,376351,139,111,13,379,1
33,610,05752,0,2,652,120,421,37,132,91,0,61,71,814,266106,132,169,91,541,2
33,610,05753,0,8,466,171,650,48,196,93,0,80,245,939,822329,325,244,93,821,8
33,611,05754,0,1,40,202,39,48,11,2,0,53,7,64,125931,60,59,2,241,1
33,611,05755,0,1,20,26,81,5,22,5,0,4,18,70,104768,22,27,5,107,1
33,611,05756,0,1,809,212,135,41,75,50,0,68,28,927,191960,96,116,50,347,1
33,611,05757,0,1,86,128,89,30,21,8,0,49,22,177,108684,71,51,8,217,1
33,611,05758,0,3,219,69,259,27,84,32,0,26,56,383,157744,82,111,32,328,3
33,611,05759,0,1,30,61,42,18,13,2,0,22,8,80,46307,30,31,2,103,1
33,612,05760,0,2,75,172,128,56,46,15,0,82,39,199,292278,121,102,15,300,2
33,612,05761,0,1,24,147,42,35,14,4,0,67,18,44,182600,85,49,4,189,1
33,612,05762,0,1,44,130,127,22,39,5,0,99,27,184,324540,126,61,5,257,1
33,612,05763,0,1,60,111,45,31,15,8,0,59,12,80,158669,71,46,8,156,1
33,612,05764,0,1,377,483,290,130,87,44,0,177,47,609,639910,224,217,44,773,1
33,612,05765,1,1,20,137,88,40,23,5,3,64,17,143,159846,81,63,8,225,2
33,612,05766,0,2,39,105,92,23,30,9,0,44,18,107,115250,62,53,9,197,2
33,612,05767,0,3,100,308,158,96,50,17,0,140,41,251,286641,181,146,17,466,3
33,613,05768,0,2,44,190,71,55,24,8,0,80,15,84,183321,95,79,8,261,2
33,613,05769,0,2,166,188,353,56,96,44,0,73,102,387,445389,175,152,44,541,2
33,613,05770,0,1,30,158,29,45,10,4,0,63,8,50,119213,71,55,4,187,1
33,613,05771,0,1,90,216,70,58,22,9,0,73,27,125,206731,100,80,9,286,1
33,613,05772,1,0,0,124,0,36,0,0,5,45,0,0,109839,45,36,5,124,1
33,614,05773,0,1,15,126,63,31,17,5,0,54,10,50,135120,64,48,5,189,1
33,614,05774,0,1,30,188,107,39,28,9,0,90,17,118,231655,107,67,9,295,1
33,614,05775,0,1,60,189,84,44,27,8,0,106,23,141,249327,129,71,8,273,1
33,614,05776,0,1,18,146,54,37,14,5,0,69,21,48,192869,90,51,5,200,1
33,614,05777,0,1,60,281,122,57,35,8,0,134,31,174,254865,165,92,8,403,1
33,614,05778,0,1,12,105,60,18,18,2,0,93,15,56,207494,108,36,2,165,1
33,614,05779,0,5,995,2,856,0,83,55,0,2,129,1085,850073,131,83,55,858,5
33,614,05780,0,1,20,125,122,33,38,2,0,44,33,168,225517,77,71,2,247,1
33,614,05781,0,1,50,399,155,80,33,20,0,151,9,104,375347,160,113,20,554,1
33,615,05782,1,2,40,188,59,52,20,8,3,62,10,80,148743,72,72,11,247,3
33,615,05783,0,3,53,167,208,47,43,25,0,56,16,91,162268,72,90,25,375,3
33,615,05784,1,0,0,335,17,124,5,0,4,109,4,20,254124,113,129,4,352,1
33,616,05785,0,0,0,188,0,46,0,0,0,52,0,0,111891,52,46,0,188,0
33,616,05786,0,2,121,480,112,129,33,12,0,162,18,179,387194,180,162,12,592,2
33,616,05787,0,1,36,268,41,64,11,5,0,95,19,56,255809,114,75,5,309,1
33,617,05788,0,2,141,170,140,40,45,17,0,96,51,220,413639,147,85,17,310,2
33,617,05789,0,1,176,211,119,63,107,91,0,72,31,246,426466,103,170,91,330,1
33,617,05790,0,2,175,227,273,79,93,72,0,70,55,301,331755,125,172,72,500,2
33,617,05791,0,1,72,230,174,62,53,15,0,105,39,178,467909,144,115,15,404,1
33,617,05792,0,1,50,192,81,50,25,6,0,76,14,119,276947,90,75,6,273,1
33,617,05793,0,1,75,202,109,59,34,13,0,134,28,153,426592,162,93,13,311,1
33,617,05794,0,1,50,231,59,59,18,6,0,73,18,110,262606,91,77,6,290,1
33,618,05795,0,2,63,245,90,62,24,8,0,136,19,107,319715,155,86,8,335,2
33,618,05796,0,2,111,109,146,22,38,23,0,68,38,171,259634,106,60,23,255,2
33,618,05797,0,1,30,149,31,44,10,3,0,58,10,50,131948,68,54,3,180,1
33,618,05798,0,1,43,148,59,41,14,6,0,74,8,63,207059,82,55,6,207,1
33,618,05799,0,2,114,246,129,71,60,33,0,100,53,254,282784,153,131,33,375,2
33,618,05800,0,2,20,111,71,29,17,3,0,59,14,60,138474,73,46,3,182,2
33,618,05801,0,0,0,35,0,12,0,0,0,20,0,0,60771,20,12,0,35,0
33,618,05802,0,2,90,160,76,37,20,5,0,86,17,130,216057,103,57,5,236,2
33,619,05803,0,1,32,65,38,20,10,4,0,31,6,52,100641,37,30,4,103,1
33,619,05804,0,1,56,227,67,59,14,4,0,83,9,88,203157,92,73,4,294,1
33,619,05805,0,1,42,133,78,33,25,13,0,47,12,82,137964,59,58,13,211,1
33,619,05806,0,1,30,143,36,32,12,2,0,48,28,54,151673,76,44,2,179,1
33,619,05807,0,2,45,118,59,27,19,7,0,44,24,145,147440,68,46,7,177,2
33,619,05808,0,1,182,273,83,68,27,17,0,90,38,234,308380,128,95,17,356,1
33,619,05809,0,2,60,176,63,38,17,4,0,70,18,100,214995,88,55,4,239,2
33,620,05810,0,3,81,172,135,58,41,12,0,64,39,168,231151,103,99,12,307,3
33,620,05811,0,2,366,174,320,41,79,46,0,80,44,514,436544,124,120,46,494,2
33,620,05812,0,2,46,150,123,48,32,6,0,62,38,166,273492,100,80,6,273,2
33,620,05813,0,2,70,135,76,36,21,9,0,48,40,110,185803,88,57,9,211,2
33,620,05814,0,2,1217,290,609,83,83,59,0,95,65,1349,511865,160,166,59,899,2
33,620,05815,0,1,48,255,53,84,21,15,0,81,7,68,246871,88,105,15,308,1
33,620,05816,0,2,239,331,119,105,57,34,0,102,42,339,396187,144,162,34,450,2
33,620,05817,0,1,22,76,77,27,15,2,0,30,23,62,123815,53,42,2,153,1
33,621,05818,0,2,60,77,98,17,29,11,0,46,16,140,219491,62,46,11,175,2
33,621,05819,0,1,56,210,49,55,13,7,0,75,6,90,162524,81,68,7,259,1
33,621,05820,0,0,0,58,0,14,0,0,0,34,0,0,89982,34,14,0,58,0
33,621,05821,0,1,408,103,255,29,51,38,0,33,64,452,228197,97,80,38,358,1
33,621,05822,0,1,42,170,42,52,10,4,0,59,15,74,158743,74,62,4,212,1
33,621,05823,0,1,48,86,44,18,11,4,0,45,9,64,108479,54,29,4,130,1
33,621,05824,0,1,72,203,76,45,19,6,0,58,17,132,170419,75,64,6,279,1
33,621,05825,0,1,18,137,29,27,9,2,0,37,6,38,110564,43,36,2,166,1
33,621,05826,0,1,126,150,107,43,26,16,0,67,17,150,195718,84,69,16,257,1
33,621,05827,0,1,8,55,26,13,8,3,0,27,5,28,86618,32,21,3,81,1
33,621,05828,0,0,0,109,0,37,0,0,0,36,0,0,87107,36,37,0,109,0
33,622,05829,0,2,120,286,112,79,29,10,0,123,18,192,275745,141,108,10,398,2
33,622,05830,0,4,240,130,196,30,65,25,0,69,92,438,300527,161,95,25,326,4
33,622,05831,0,1,210,99,212,26,29,19,0,70,19,226,157529,89,55,19,311,1
33,622,05832,0,2,52,325,141,89,38,20,0,132,21,118,288648,153,127,20,466,2
33,622,05833,0,2,54,140,97,38,27,12,0,70,22,98,207223,92,65,12,237,2
33,622,05834,0,1,38,133,52,29,13,6,0,47,10,58,109267,57,42,6,185,1
33,623,05835,0,1,108,268,132,68,33,19,0,103,21,152,291358,124,101,19,400,1
33,623,05836,0,1,65,209,215,62,70,11,0,100,93,237,494337,193,132,11,424,1
33,623,05837,0,2,44,160,128,45,37,10,0,65,43,203,234482,108,82,10,288,2
33,623,05838,0,1,135,174,57,50,23,15,0,82,20,167,195756,102,73,15,231,1
33,623,05839,0,1,12,157,78,36,23,4,0,69,25,133,200510,94,59,4,235,1
33,623,05840,0,1,145,144,121,40,36,16,0,69,23,215,229612,92,76,16,265,1
33,623,05841,0,6,2270,80,1302,19,337,236,0,41,189,2601,1391980,230,356,236,1382,6
33,624,05842,0,1,69,222,102,69,22,11,0,60,37,135,180789,97,91,11,324,1
33,624,05843,0,1,260,137,251,36,53,20,0,61,48,421,217358,109,89,20,388,1
33,624,05844,0,1,100,155,226,54,47,24,0,46,38,157,199983,84,101,24,381,1
33,624,05845,0,4,250,222,488,57,128,35,0,88,149,538,435027,237,185,35,710,4
33,624,05846,0,1,32,255,35,81,9,3,0,97,17,52,212700,114,90,3,290,1
33,625,05847,0,1,66,232,151,72,34,7,0,72,65,180,347629,137,106,7,383,1
33,625,05848,0,1,90,126,126,35,42,14,0,63,49,180,293157,112,77,14,252,1
33,625,05849,0,2,122,134,198,40,57,15,0,63,95,297,426753,158,97,15,332,2
33,625,05850,0,1,256,81,216,17,51,28,0,39,46,403,251097,85,68,28,297,1
33,625,05851,0,1,18,45,66,11,18,5,0,25,13,80,105412,38,29,5,111,1
33,625,05852,0,0,0,103,0,28,0,0,0,45,0,0,103123,45,28,0,103,0
33,625,05853,0,1,276,179,179,45,43,25,0,68,49,346,246236,117,88,25,358,1
33,625,05854,0,1,50,95,88,21,30,11,0,40,42,114,168607,82,51,11,183,1
33,626,05855,1,0,0,165,60,49,19,0,5,64,32,64,211988,96,68,5,225,1
33,626,05856,1,1,128,217,96,56,25,15,2,113,28,168,265142,141,81,17,313,2
33,626,05857,0,1,62,121,71,29,11,5,0,51,18,78,113432,69,40,5,192,1
33,626,05858,0,1,50,152,51,31,9,2,0,48,9,70,135658,57,40,2,203,1
33,626,05859,0,1,18,133,31,40,9,3,0,60,18,40,145277,78,49,3,164,1
33,626,05860,0,3,213,172,307,41,67,29,0,96,38,316,399232,134,108,29,479,3
33,626,05861,0,1,62,73,72,34,13,3,0,18,19,86,82675,37,47,3,145,1
33,627,05862,0,1,153,94,179,21,69,30,0,68,50,303,321323,118,90,30,273,1
33,627,05863,0,1,36,99,42,23,8,2,0,35,8,58,74991,43,31,2,141,1
33,627,05864,0,1,56,136,63,41,15,5,0,64,10,106,139581,74,56,5,199,1
33,627,05865,0,1,10,215,32,68,9,2,0,55,4,38,123356,59,77,2,247,1
33,627,05866,0,1,1300,65,449,19,246,210,0,30,73,1403,478328,103,265,210,514,1
33,627,05867,0,1,56,108,137,33,34,8,0,82,20,138,202931,102,67,8,245,1
33,627,05868,0,2,122,193,250,57,69,14,0,73,51,346,310945,124,126,14,443,2
33,627,05869,0,1,50,91,25,21,9,2,0,33,19,70,98690,52,30,2,116,1
33,628,05870,0,2,84,124,132,41,40,10,0,38,45,188,194156,83,81,10,256,2
33,628,05871,0,1,56,300,57,78,20,4,0,119,19,95,350144,138,98,4,357,1
33,628,05872,0,1,30,41,36,6,12,2,0,32,14,54,123137,46,18,2,77,1
33,628,05873,0,3,376,303,289,78,91,39,0,94,61,579,399942,155,169,39,592,3
33,628,05874,0,1,46,95,121,24,33,6,0,29,25,147,141416,54,57,6,216,1
33,628,05875,0,1,10,162,31,49,8,2,0,65,31,50,176138,96,57,2,193,1
33,628,05876,0,5,359,234,598,56,325,18,0,79,36,729,642793,115,381,18,832,5
33,628,05877,0,0,0,133,0,41,0,0,0,45,0,0,91176,45,41,0,133,0
33,628,05878,0,3,117,146,341,36,105,22,0,70,82,394,428031,152,141,22,487,3
33,628,05879,0,1,34,172,125,45,42,11,0,74,31,191,225587,105,87,11,297,1
33,628,05880,0,0,0,318,119,88,34,0,0,108,45,147,304652,153,122,0,437,0
33,629,05881,0,3,50,221,374,64,115,11,0,58,143,452,590567,201,179,11,595,3
33,629,05882,0,3,184,197,390,64,117,20,0,64,169,621,606706,233,181,20,587,3
33,629,05883,0,1,73,155,133,48,36,10,0,50,24,228,120904,74,84,10,288,1
33,629,05884,0,4,349,313,475,104,143,32,0,105,138,812,552175,243,247,32,788,4
33,630,05885,0,1,56,158,94,26,24,6,0,89,35,124,346447,124,50,6,252,1
33,630,05886,0,1,12,100,53,25,15,2,0,57,14,52,240864,71,40,2,153,1
33,630,05887,0,1,10,199,52,49,17,2,0,89,20,53,243445,109,66,2,251,1
33,630,05888,0,0,0,370,26,95,10,0,0,144,35,41,441148,179,105,0,396,0
33,630,05889,0,1,10,258,51,71,14,2,0,107,11,50,234853,118,85,2,309,1
33,631,05890,0,1,215,268,162,51,56,42,0,118,33,515,539638,151,107,42,430,1
33,631,05891,0,1,77,488,145,133,97,76,0,195,42,197,597071,237,230,76,633,1
33,631,05892,0,1,60,228,55,63,24,10,0,124,14,93,347460,138,87,10,283,1
33,631,05893,0,1,12,190,26,44,8,2,0,75,5,22,182310,80,52,2,216,1
33,631,05894,0,1,50,167,51,38,15,8,0,59,8,70,213213,67,53,8,218,1
33,632,05895,0,1,116,256,124,87,40,16,0,87,46,204,260118,133,127,16,380,1
33,632,05896,0,1,11,61,122,14,41,5,0,43,54,180,321051,97,55,5,183,1
33,632,05897,0,4,155,210,420,51,137,44,0,70,117,563,637389,187,188,44,630,4
33,632,05898,0,6,537.8405799865723,92,836,29,242.2753629684448,96.88405799865723,0,47,241,1035.594207763672,1592646,288,271.27536,96.884056,928,6
33,632,05899,0,3,248,364,253,79,86,28,0,156,83,491,575928,239,165,28,617,3
33,632,05900,0,1,41,0,80,0,26,12,0,0,9,75,70859,9,26,12,80,1
33,633,05901,0,1,30,149,71,40,25,4,0,51,34,114,209385,85,65,4,220,1
33,633,05902,0,1,425,162,213,47,63,27,0,75,32,540,282729,107,110,27,375,1
33,633,05903,0,2,52,196,202,58,63,18,0,74,47,232,340899,121,121,18,398,2
33,633,05904,0,2,400,75,441,25,78,18,0,29,170,786,981247,199,103,18,516,2
33,633,05905,0,1,91,185,76,53,22,3,0,72,18,145,245522,90,75,3,261,1
33,633,05906,0,1,168,151,133,52,23,9,0,67,50,202,237815,117,75,9,284,1
33,633,05907,0,0,0,145,74,34,23,0,0,62,17,82,181386,79,57,0,219,0
34,634,05908,0,1,100,0,89,0,32,22,0,0,14,111,55626,14,32,22,89,1
34,635,05909,0,5,1178,94,2125,20,387,191,0,9,59,1680,316432,68,407,191,2219,5
34,635,05910,0,4,1860,0,1146,0,267,215,0,0,47,2050,300104,47,267,215,1146,4
34,635,05911,0,0,0,456,180,110,34,0,0,47,17,28,213278,64,144,0,636,0
34,635,05912,0,0,0,479,0,95,0,0,0,33,0,0,120475,33,95,0,479,0
34,636,05913,0,2,201,0,216,0,38,25,0,0,12,242,41816,12,38,25,216,2
34,637,05914,0,1,506,198,513,49,75,36,0,15,17,774,144200,32,124,36,711,1
34,637,05915,0,0,0,299,0,91,0,0,0,19,0,0,56022,19,91,0,299,0
35,638,05916,1,0,0,6,0,3,0,0,0,15,0,0,17841,15,3,0,6,1
35,638,05917,0,0,0,71,0,6,0,0,0,21,0,0,10425,21,6,0,71,0
35,638,05918,0,0,0,2,0,4,0,0,0,6,0,0,8054,6,4,0,2,0
35,639,05919,0,0,0,45,0,9,0,0,0,21,0,0,43010,21,9,0,45,0
35,639,05920,0,0,0,41,0,13,0,0,0,15,0,0,25594,15,13,0,41,0
35,639,05921,0,0,0,107,0,13,0,0,0,28,0,0,36080,28,13,0,107,0
35,640,05922,1,1,45,127,32,21,3,3,3,31,2,45,53495,33,24,6,159,2
35,640,05923,2,2,452,32,17,14,0,0,2,30,15,483,165686,45,14,2,49,4
35,640,05924,0,0,0,46,0,4,0,0,0,7,0,0,18771,7,4,0,46,0
